Gg, Rp, Gs^Fms, Hh^Fms, Hh^Fms, Hh, Hh, Mm^Xm, Mm^Xm, Mm^Xm, Mm^Xm, Mm^Xm, Mm^Xm, Mm^Xm, Mm^Xm, Mm, Mm, Mm, Mm, Mm^Xm, Mm^Xm, Mm^Xm, Mm^Xm, Mm^Xm, Mm^Xm, Mm^Xm, Mm^Xm, Wo, Wo, Wo, Mm^Xm, Mm^Xm, Mm^Xm, Ww, Ww, Wo, Wo, Wo, Ww, Wo
Gg, Rp, Rp, Hh, Gs^Fms, Hh^Fms, Hh, Mm^Xm, Mm, Mm^Xm, Mm^Xm, Mm^Xm, Mm, Mm, Mm, Mm, Mm, Mm, Mm, Mm, Mm, Mm, Mm, Mm, Mm, Mm^Xm, Ww, Wo, Wo, Mm^Xm, Mm^Xm, Mm^Xm, Mm^Xm, Mm, Mm, Ww, Wo, Wo, Ww, Ww
Gg, Gg, Rp, Gg, Gg, Gs^Fms, Hh, Hh, Mm, Mm, Hh, Mm, Hh^Fms, Hh, Hh^Fms, Hh, Mm, Mm, Mm, Hh, Hh, Hh, Wwf^Es, Ww, Ww, Ww, Ww, Wo, Mm, Mm^Xm, Mm^Xm, Mm^Xm, Mm^Xm, Mm, Mm, Ww, Ww, Wo, Ww, Ww
Gg, Gg, Rp, Gg, Gg, Gg, Gg, Gg, Gg, Hh, Hh, Hh, Hh^Fms, Hh^Fms, Hh^Fms, Hh, Mm, Mm, Hh, Hh, Hh, Hh, Wo, Wo, Ww, Mm, Mm, Mm, Mm, Mm, Mm, Mm^Xm, Mm^Xm, Mm, Mm, Mm, Ww, Ww, Mm, Mm
Gs^Fms, Gg, Gg, Rp, Rp, Gg, Gg^Efm, Gg, Gg^Vh, Gg, Gg, Hh, Hh, Hh, Hh, Mm, Mm, Ds, Hh^Vhh, Ds, Ds, Ww, Ww, Ww, Hh, Hh, Hh, Mm, Mm, Mm, Mm, Mm, Hh, Mm, Mm, Ww, Mm, Mm, Mm^Xm, Mm
Gs^Fms, Gs^Fms, Gs^Fms, Gg, Gg, Rp, Gg, Gg, Gg, Gg, Gg, Hh, Gg, Gg, Hh, Hh, Hh, Ds, Ds, Ds, Ww, Ww, Wwg^Ewf, Ww, Ss, Hh, Gg, Hh, Gg, Hh, Mm, Mm, Hh, Hh, Mm, Ww, Ww, Mm, Mm, Mm
Gs^Fms, Gs^Fms, Gs^Fms, Gg, Gg, Rp, Rp, Gg, Gg^Efm, Gg, Gg^Efm, Gg, Gg, Gg, Gg, Gg, Hh, Hh, Hh, Ds, Ww, Ww, Ww, Ww, Gg, Gg, Gg, Gg, Gg, Gg, Hh, Hh, Gg, Gg, Hh, Mm, Mm, Ww, Mm, Mm
Gs^Fms, Gs^Fms, Gg, Gg, Gg, Gg^Efm, Gg, Rp, Rp, Gg, Gg, Gg, Gg, Hh, Hh, Gg, Gg, Hh, Ds, Ds, Hh, Hh, Hh, Hh, Hh, Hh, Gs^Fms, Gg, Gg, Gg, Hh, Hh, Gg, Gg, Gg, Hh, Ww, Ww, Hh, Hh
Gg, Gs^Fms, Gg, Gg^Vct, Gg, Gg, Ce, Gg, Gg, Rp, Gg, Gg^Efm, Gg, Gg, Gg, Gg, Gg, Hh, Hh, Gg, Gs, Hh, Hh, Gs^Fms, Hh^Fp, Gg, Gg, Gll^Fp, Gll^Fp, Gll^Fp, Gll^Fp, Gll^Fp, Gll^Fp, Chr, Chr, Gg, Ww, Gg, Hh, Hh
Gg, Gg, Gg, Gg, Gg, Ce, Ce, Ce, Ce, Rp, Rp, Rp, Rp, Gg, Gg, Gll^Fp, Gll^Fp, Gll^Fp, Gg, Gg, Gs, Gs^Fms, Hh, Hh, Gll^Fp, Gll^Fp, Gs^Fms, Gll^Fp, Gll^Fp, Gll^Fp, Gg^Efm, Gg, Gg, Gg, Chr, Hh, Ww, Hh, Gg, Hh
Gg, Gg, Gg^Efm, Gg, Gg, Ce, Gs, 1 Ke, Ce, Re, Re, Gg, Rp, Gg, Gg, Gg, Gg, Hh, Gll^Fp, Gg, Hh, Gs, Gll, Hh^Fp, Gll^Fms, Gs, Gll, Gs^Fms, Gs^Fms, Gs^Fms, Gs^Efm, Gs, Gg, Gg, Gg, Hh, Ww, Ww, Hh, Gg
Gg, Gg, Gs^Efm, Gg^Efm, Gg, Gg, Ce, Ce, Gs, Re, Gg, Gg, Rp, Gg^Vh, Hh, Gg, Gg, Hh, Gg, Gll^Fp, Gll^Fp, Gll, Gg, Gg, Gg, Gg, Gll, Gll^Fp, Gll^Fp, Gll, Gll^Efm, Gs, Gs^Efm, Gg, Gg, Gg, Ww, Gg, Gg, Hh
Gg, Gs, Gg, Gg, Re^Vct, Gg, Gg, Gg, Gg, Gg^Efm, Gg^Efm, Gg, Rp, Gg, Gg, Gg, Gg, Gll^Fp, Gg, Gs^Fms, Gll^Fp, Gll^Fp, Gll^Fp, Gs^Fms, Gs^Fms, Gg, Gs^Fms, Gll^Fp, Hh^Fp, Gs^Fp, Gll^Es, Gs^Fp, Gll^Fp, Gs, Gg^Fp, Gg^Fp, Ww, Gg, Re, Gg
Gg, Gs, Rp, Gg, Gg, Gg, Gg, Gg^Efm, Gg, Gg^Efm, Gg, Gg, Gg, Rp, Gg, Gg, Gll^Fp, Gll^Fp, Gll^Fp, Gll^Fp, Gg, Gg, Gs^Fms, Gll^Fp, Gs^Fds, Gs^Fds, Gs^Fds, Gs^Fds, Hh^Fp, Hh, Gg, Gs, Gll^Fms, Gll^Fp, Gll^Fp, Gll^Fp, Re, Ww^Bw/, Gg, Re
Rp, Rp, Gg, Rp, Gg, Gg, Gs^Fms, Gg, Gg, Gg, Gll^Fp, Gll^Fp, Gg, Rp, Gg, Gg, Gll^Fp, Hh, Gg, Gs^Fms, Gg, Hh, Gg, Gll^Fp, Gs^Fms, Gg, Gs^Fms, Gs^Fms, Hh, Gs^Fms, Gs^Fms, Gg, Gs^Fds, Gll^Fms, Gll^Fp, Re, Ww, Ww, Gg, Gg
Gg, Gg, Gs^Fds, Rp, Gg, Gg, Gg, Gg, Gg, Gg, Gll^Fp, Gll^Fp, Gg, Rp, Gg, Gll^Fp, Gg, Gg, Gg, Gg, Gs^Fms, Gg, Gs, Gll^Fp, Gs, Gll^Fp, Gll^Fp, Gs^Fms, Gg, Gg, Gs^Fms, Gs^Fms, Gs^Fds, Gs^Fds, Gs, Re, Ww, Gg, Gg, Gg
Gs^Fds, Gs^Fds, Gs^Fds, Rp, Rp, Rp, Rp, Gg, Gg, Gll^Fp, Gg, Gll^Fp, Gg, Rp, Rp, Gll^Fp, Gg, Gg, Gg, Gg, Ds, Gs, Gg, Gs^Fms, Gs^Fms, Gs, Gs, Gg, Gg, Gs^Fms, Re, Gll^Fp, Gll^Fp, Gll^Fms, Gs^Fms, Re, Ww, Gg, Gg, Gg
Gs^Fds, Gs^Fds, Gg, Gg, Gg^Vh, Gg, Gg, Rp, Rp, Gg, Ww, Gg, Ww, Gg, Ww, Rp, Ww, Ww, Ww, Ds, Wo, Ds, Gg, Gs^Fms, Gg, Gg, Gs, Gs^Fms, Re, Re, Re, Gll^Fp, Gll^Em, Gll^Fms, Re, Re, Gg, Ww, Gg, Gg
Gs^Fds, Gs^Fds, Gg, Gg, Gg, Gg, Ww, Gg, Ww, Ww^Bw\, Wo^Bw\, Ww, Wo, Wo, Ww, Ww^Bsb|, Ww, Wo, Wo, Wo, Ww, Ds, Ww, Gg, Re, Re, Re, Re, Re, Re^Fms, Gs^Fms, Re, Re, Re, Re^Vh, Gg, Ww, Ww, Ww, Ww
Gg, Gg, Gg, Gg, Ww, Ww, Ww^Ewf, Ww, Ww, Wo, Ww, Wo^Bw|, Ww, Ww, Ww, Rp, Ds, Ww, Ww, Ww, Ww, Ww, Ww^Bw|, Ww^Bw/, Ww, Gs^Vc, Gs, Gs, Gll^Fp, Gs^Fms, Gs^Fds, Re^Eff, Re^Eff, Re^Fms, Gll, Gg, Ww, Ww, Ww, Ww
Gg, Gg, Ww, Ww, Re, Ww, Ww, Ww, Gg, Ww, Gg, Rp, Gg, Ww, Rp, Rp, Gs, Ds, Gs, Gs, Gg, Ww, Gg, Ww, Ww, Wwf, Gg, Gs, Gg, Gs^Fds, Gs^Fds, Gll^Fp, Gll^Fp, Gll^Fms, Gll, Ww, Wo, Wo, Ww, Ww
Ss, Ss, Ww, Gs^Vl, Gs^Fds, Re, Re^Gvs, Re^Gvs, Re^Gvs, Gs, Gs, Rp, Gs, Gs, Rp, Gg, Gs, Gs, Gll^Fp, Gs, Gs, Gg, Gs, Gs, Gg, Ww, Gg, Gg, Gg, Gs^Fds, Gs^Fms, Gg, Gll^Fp, Gll^Fp, Gg, Ww, Ww, Wo, Ww, Ww
Gs^Fds, Gs^Fds, Ww, Gs^Fds, Gs^Fds, Re^Gvs, Re^Gvs, Re^Gvs, Re^Gvs, Re^Gvs, Gs, Rp, Rp, Gs, Rp, Gs, Gs, Gll^Fp, Gs^Efm, Gll^Fp, Gll^Fp, Gll, Chr, Chr, Re, Ww, Ww^Bw/, Gg, Gg, Gg, Gg, Gg, Gg, Gs^Fms, Gg^Vh, Gg, Chw, Ww, Gg, Gg
Gs^Fds, Gs^Fds, Gs^Fds, Ww, Ww, Gs^Fds, Gs, Re^Gvs, Gs, Gs, Gs, Gs, Rp, Rp, Gg, Gg, Gg^Efm, Gs^Efm, Gs^Efm, Gll^Fp, Gll^Fp, Gll, Chr, Khr, Re, Gs, Re^Edb, Ww, Ww, Ww, Ww, Gg, Gg, Gs^Fms, Gs^Fms, Gg, Ww, Ww, Ww, Gg
Gs^Fds, Re^Em, Gs^Fds, Gs^Fds, Ww, Gs, Gs, Gs, Gs^Fds, Gs^Fds, Gs, Rp, Gs, Gs, Gg, Gs^Efm, Gs^Efm, Gs, Gs, Gs, Gs, Gg, Re, Re, Re, Re, Re^Edb, Gg, Gs, Re^Edb, Re, Ww, Ww, Ww, Ww, Ww, Ds^Es, Ds, Ww, Ww
Gs^Fds, Gs^Fds, Gs^Fds, Ww, Gs^Fds, Gs, Gs, Gs, Re, Gs^Fds, Re, Rp, Rp, Gs, Gs, Gs, Rp, Gs, Rp, Gs, Gs, Gs, Gd^Es, Gd^Es, Re, Re, Gd^Es, Gd^Es, Gd, Gs, Chr, Chw, Gg, Ww, Gs^Fms, Wo, Wo, Ds^Es, Ww, Ww
Gs^Fds, Gs^Fds, Gs^Fds, Ww, Re, Re, Re, Re, Gs, Re, Gs, Gs, Gs, Rp, Rp, Rp, Gs, Rp, Gs, Rp, Rp, Gs, Gd^Es, Re, Re, Re^Vhhr, Re, Re^Edb, Re, Chr, 2 Khr, Chr, Gs, Gs, Gs^Fms, Gg, Wo, Ds, Ww, Ww
Hh^Fds, Gs^Fds, Re, Wwf, Ww, Gs, Gs^Fds, Gs, Re, Gs^Vh, Re^Gvs, Re^Gvs, Re^Gvs, Gs^Eff, Gs^Eff, Gs, Gs^Wm, Gs, Gs, Gs, Rp, Re, Re, Re, Gs, Re, Gs^Edb, Re^Edb, Gs, Chr, Chr, Gs^Fms, Gs^Fms, Gll^Fp, Gll^Fp, Gs^Em, Ww, Ds, Ww, Ww
Hh, Hh, Gs^Vhcr, Gs^Fds, Ww, Gs, Gs^Fds, Gs, Re^Gvs, Re^Gvs, Re^Gvs, Re^Gvs, Gs^Eff, Gs^Eff, Gs, Gs, Gs, Gd, Gs, Gs, Gs, Rp, Chr, Chr, Gd, Gd, Gd, Gd, Gd, Chr, Gs, Gs^Fms, Gs^Fms, Gll^Fp, Gll^Fp, Gll^Fp, Gll^Fp, Ww, Gll^Fp, Ww
Mm, Hh, Hh, Gs^Fds, Ww, Gs^Fds, Gs^Fds, Gs^Fms, Gs^Fms, Re^Gvs, Gs^Fms, Gs^Eff, Gs^Fds, Gs, Gd^Fms, Gs^Fms, Gd^Fms, Gd, Gs^Fms, Gs, Gs, Rp, Rp, Chr, Gs, Gs^Fms, Gd^Fms, Gs, Gd^Fms, Gs, Gs^Fms, Gs^Fms, Gs^Vh, Gll^Fp, Gll^Fp, Gll^Fp, Gll^Fp, Gll^Fp, Gll^Fp, Gll^Fp
Mm, Mm, Hh, Hh, Ww, Gs^Fds, Gs^Fds, Gs^Fms, Gs^Fds, Gs^Fms, Gs^Fds, Gs^Fds, Gs^Fds, Gs, Gs, Gd^Fms, Gs^Fms, Gs^Fms, Gs^Fms, Gs, Gs, Gs, Rp, Gs, Gs, Gd^Fms, Gs^Fms, Gd^Fms, Gs^Fms, Gs^Fms, Gs^Fms, Gs^Fms, Gs^Fms, Gs^Fms, Gs^Fms, Gs^Fms, Gs^Fms, Gll^Fp, Gs^Fms, Gs^Fms
Mm, Mm, Hh, Hh, Ww, Gs^Fds, Gs^Fds, Gs^Fms, Gs^Fds, Gs^Fms, Gs^Fds, Gs^Fds, Gs^Fds, Gs, Gs, Gd^Fms, Gs^Fms, Gs^Fms, Gs^Fms, Gs, Gs, Gs, Rp, Gs, Gs, Gd^Fms, Gs^Fms, Gd^Fms, Gs^Fms, Gs^Fms, Gs^Fms, Gs^Fms, Gs^Fms, Gs^Fms, Gs^Fms, Gs^Fms, Gs^Fms, Gll^Fp, Gs^Fms, Gs^Fms
