Ai, Ai, Wog, Wog, Ai, Ms^Xm, Ms^Xm, Ms, Ha, Aa, Aa, Aa, Aa, Rd, Rd, Gd, Gd, Aa^Qhh, Aa, Aa, Ms, Ms, Ms^Xm, Ms^Xm, Ms^Xm, Gd, Ms^Xm, Ms^Xm, Ms^Xm
Ai, Ai, Wog, Ai, Ms^Xm, Ms^Xm, Ms, Ms, Ha, Aa, Aa, Aa, Gd, Aa, Aa, Gd, Gd, Aa^Qhh, Aa, Aa, Ha, Ms, Xue, Ms^Xm, Ms^Xm, Ms^Xm, Ms^Xm, Ms^Xm, Ms^Xm
Wog, Wog, Wwg, Ms^Xm, Ai, Ms, Aa, Ha, Gd, Aa, Aa, Gd, Rd, Cea, 1 Kea, Cea, Aa, Aa^Qhh, Gd, Gd, Ha, Uue, Uue, Xue, Ms^Xm, Ms^Xm, Ms^Xm, Ms^Xm, Ms^Xm
Wog, Wog, Ai, Wwg, Wwrg, Aa, Ms, Gd, Gd, Aa, Aa, Gd, Rd, Cea, Gd, Cea, Aa^Qhh, Aa^Qhh, Ms, Ha, Xue, Uhe, Re, Xue, Xue, Ms^Xm, Ms^Xm, Ms^Xm, Ms^Xm
Ms^Xm, Ms, Ms, Ha, Ha, Ms, Ms^Xm, Ms, Ms, Aa, Ha, Aa, Aa, Rd, Gd, Gd, Ha^Qhh, Ms, Ms^Xm, Ms^Xm, Xue, Uhe, Re, Uue, Uue, Xue, Ms^Xm, Ms^Xm, Ms^Xm
Ms^Xm, Ms^Xm, Xue, Ha, Uue, Xue, Xue, Ms, Ms, Ha, Ha, Ha, Aa, Rd, Aa, Aa, Aa^Qhh, Ms, Ms^Xm, Ms^Xm, Ms^Xm, Xue, Uhe, Uhe, Uue, Xue, Ms^Xm, Ms^Xm, Ms^Xm
Ms^Xm, Ms^Xm, Xue, Uhe, Uue, Xue, Xue, Ms, Ms, Ms, Ms^Xm, Ha, Aa, Aa, Gd, Aa, Aa^Qhh, Ha, Ha, Ms, Ms^_mh, Xue, Uue, Re, Uhe, Xue, Xue, Ms^Xm, Ms^Xm
Ms^Xm, Ms^Xm, Xue, Uhe, Re, Re, Uhe, Xue, Xue, Xue, Ms^Xm, Ha, Ha, Gd, Gd, Rd, Aa, Aa^Qhh, Aa, Ms, Ms^Xm, Xue, Xue, Re, Uue, Uhe, Ms, Ms^Xm, Ms^Xm
Ms^Xm, Ms^Xm, Ms^Xm, Xue, Uue, Uhe, Re, Uue, Xue, Xue, Ms^Xm, Ms^Xm, Ms, Gd, Aa, Rd, Rd, Aa^Qhh, Ms, Ms^Xm, Ms^Xm, Ms^Xm, Ms^Xm, Xue, Xue, Uue, Ha^Qhh, Ms, Ha^Qhh
Ms^Xm, Ms^Xm, Ms^Xm, Xue, Uue, Re, Re, Uhe, Xue, Xue, Ms, Ms, Ms, Aa, Aa, Ha, Ha, Gd^Qhh, Ha, Ms, Ha, Ms^Xm, Ms, Ms^Xm, Ms, Ha^Qhh, Aa, Aa^Qhh, Aa
Ms^Xm, Ms^Xm, Xue, Xue, Xue, Uue, Uhe, Re, Ha, Ha, Ms, Ms, Ha, Aa, Aa, Aa, Rd, Gd^Qhh, Aa^Qhh, Ha, Aa^Qhh, Aa^Qhh, Ha^Qhh, Ms, Aa^Qhh, Aa^Qhh, Gd, Gd, Aa^Qhh
Ms^Xm, Ms^Xm, Ms^Xm, Xue, Ms^Xm, Xue, Aa, Ha, Gd, Aa, Aa, Ha, Gd, Gd, Rd, Rd, Ha, Gd, Gd, Aa^Qhh, Aa, Aa, Aa, Ha^Qhh, Aa, Aa, Gd^Qhh, Gd^Qhh, Ha
Ms^Xm, Ms^Xm, Ms^Xm, Ms^Xm, Ms^Xm, Ms, Ha, Aa, Aa, Gd, Aa, Rd, Aa, Aa, Ms, Ha, Ms, Gd, Ha, Aa, Aa, Aa, Aa, Gd, Gd, Aa^Qhh, Aa, Ha, Ms
Ms^Xm, Ms^Xm, Ms, Ms^Xm, Ha, Ha, Ai^Qhu, Gd^Qhu, Gd^Qhu, Aa, Rd, Rd, Aa, Ms, Ms, Ms, Ms, Ha, Ha, Gd, Gd^Qhh, Aa^Qhh, Aa^Qhh, Gd, Aa^Qhh, Aa^Qhh, Ha, Ms, Ms^Xm
Ai^Qhu, Aa, Aa, Aa, Ai^Qhu, Ai^Qhu, Aa, Aa^Qhu, Gd^_ml, Gd^Qhu, Rd, Ha, Ms, Ms^Xm, Ms^Xm, Ms, Ms^Xm, Ms, Aa^Qhh, Gd^Qhh, Gd, Aa, Ms, Aa^Qhh, Ha, Aa, Ms, Ms^Xm, Ms^Xm
Ai^Qhu, Ai^Qhu, Ai^Qhu, Ai^Qhu, Ai^Qhu, Ai^Qhu, Aa, Aa^Qhu, Aa^Qhu, Aa^Qhu, Rd, Ha, Ha, Ms, Ms^Xm, Ms^Xm, Ms, Ha, Rd^Qhh, Aa, Ha, Aa, Ms^Xm, Ms, Uue, Ms, Ms, Ms^Xm, Ms^Xm
Ai^Qhu, Aa, Aa, Ai^Qhu, Aa, Aa, Gd, Aa, Aa^Qhu, Aa^Qhu, Aa^Qhu, Rd, Gd, Ms, Ms, Ms^Xm, Ha, Ha, Rd^Qhh, Ha, Ms, Ms, Ms^Xm, Xue, Uhe, Uue, Xue, Ms^Xm, Ms^Xm
Ha, Ha, Aa, Aa, Aa, Gd, Gd, Aa, Aa^Qhu, Gd^Qhu, Gd^Qhu, Rd, Gd, Gd, Aa, Aa, Aa^Qhh, Rd^Qhh, Ms, Ha, Ms^Xm, Ms^Xm, Xue, Xue, Uue, Re, Xue, Ms^Xm, Ms^Xm
Ms^Xm, Ms, Ha, Ha, Ha^Qhh, Gd, Aa^Qhh, Aa, Aa, Aa^Qhu, Gd^Qhu, Gd^Qhu, Rd, Gd, Aa^Qhh, Aa^Qhh, Ha, Ms, Ms, Ms, Xue, Xue, Uue, Re, Uue, Re, Xue, Ms^Xm, Ms^Xm
Ms^Xm, Ms, Ha, Ha^Qhh, Cva, Ha^Qhh, Cva, Aa^Qhh, Aa^Qhh, Aa, Aa, Aa^Qhu, Rd, Aa, Gd^Qhh, Aa, Ha, Ha, Ms^Xm, Ms^Xm, Xue, Uhe, Uue, Uhe, Uhe, Xue, Qxu, Ms^Xm, Ms^Xm
Ms^Xm, Ms^Xm, Ha, Aa^Qhh, Rra, Rra, Ha, Ha, Aa^Qhh, Aa, Gd, Gd^Qhu, Rd, Aa, Gd^Qhh, Gd, Ms, Ms, Ms, Ms^Xm, Xue, Xue, Re, Re, Uue, Xue, Qxu, Ms^Xm, Ms^Xm
Ms^Xm, Ms^Xm, Ms, Ha^Qhh, 4 Kva, Cva^Feta, Rra^_mhh, Cva, Aa^Qhh, Aa, Gd^Qhu, Gd^Qhu, Rd, Aa, Aa, Aa^Qhh, Aa, Ms, Ha, Xue, Uue, Uue, Re, Uue, Xue, Xue, Qxu, Ms^Xm, Ms^Xm
Ms^Xm, Ms^Xm, Ms^Xm, Ha^Qhh, Ha^Qhh, Rra, Cva, Aa^Qhh, Ha, Aa, Aa^Qhu, Aa^Qhu, Gd, Gd, Aa, Aa^Qhh, Aa, Ha, Aa, Ha, Uhe, Uhe, Re, Uhe, Xue, Qxu^_mh, Ms^Xm, Ms^Xm, Ms^Xm
Ms^Xm, Ms^Xm, Ms^_mh, Ms^Xm, Ms^Xm, Ha^Qhh, Ha^Qhh, Ha^Qhh, Aa, Aa^Qhu, Aa, Aa, Aa, Rd, Aa, Aa^Qhh, Gd, Aa, Ha, Aa, Ms, Xue, Xue, Xue, Qxu, Qxu, Ms^Xm, Ms^Xm, Ms^Xm
Ms^Xm, Ms^Xm, Ms^Xm, Ms^Xm, Ms^Xm, Ms, Ms, Ms, Aa^Qhu, Aa^Qhu, Gd, Aa, Aa, Aa, Rd, Gd^Qhh, Gd^Qhh, Ha, Ha, Ms, Ms^Xm, Ms^Xm, Ms^Xm, Qxu, Ms^Xm, Ms^Xm, Ms^Xm, Ms^Xm, Ms^Xm
Ms^Xm, Ms^Xm, Ms^Xm, Ms^Xm, Ms^Xm, Ms^Xm, Ms^Xm, Ha, Aa^Qhu, Aa, Gd, Gd, Aa, Aa, Aa, Rd, Gd, Aa^Qhh, Aa, Aa, Ms^Xm, Ms^Xm, Ms^Xm, Ms^Xm, Ms^Xm, Ms^Xm, Ms^Xm, Ms^Xm, Ms^Xm
