Gd, Gd, Gd, Gd, Gd, Gd, Gd, Gd, Gd, Gd, Gd, Gd, Gd, Re, Re, Gd, Gd, Gd, Gd, Gd, Ms, Ms, Ms^Xm, Ms^Xm, Ms^Xm, Gd, Ms^Xm, Ms^Xm, Ms^Xm
Gd, Gd, Gd, Gd, Gd, Gd, Gd, Gd, Gd, Gd, Gd, Gd, Gd, Gd, Gd, Gd, Gd, Gd, Gd, Gd, Gd, Ms, Xue, Ms^Xm, Ms^Xm, Ms^Xm, Ms^Xm, Ms^Xm, Ms^Xm
Gd, Gd, Gd, Gd, Gd, Gd, Gd, Gd, Gd, Gd, Gd, Gd, Re, Cea, 1 Kea, Cea, Gd, Gd, Gd, Gd, Gd, Uue, Uue, Xue, Ms^Xm, Ms^Xm, Ms^Xm, Ms^Xm, Ms^Xm
Gd, Gd, Gd, Gd, Gd, Gd, Ms, Gd, Gd, Gd, Gd, Gd, Re, Cea, Gd, Cea, Gd, Gd, Ms, Gd, Xue, Uhe, Re, Xue, Xue, Ms^Xm, Ms^Xm, Ms^Xm, Ms^Xm
Ms^Xm, Ms, Ms, Gd, Gd, Ms, Ms^Xm, Ms, Ms, Gd, Gd, Gd, Gd, Re, Gd, Gd, Gd, Ms, Ms^Xm, Ms^Xm, Xue, Uhe, Re, Uue, Uue, Xue, Ms^Xm, Ms^Xm, Ms^Xm
Ms^Xm, Ms^Xm, Xue, Gd, Uue, Xue, Xue, Ms, Ms, Ms, Gd, Gd, Gd, Re, Gd, Gd, Gd, Ms, Ms^Xm, Ms^Xm, Ms^Xm, Xue, Uhe, Uhe, Uue, Xue, Ms^Xm, Ms^Xm, Ms^Xm
Ms^Xm, Ms^Xm, Xue, Uhe, Uue, Xue, Xue, Ms, Ms, Ms, Ms^Xm, Gd, Gd, Gd, Gd, Gd, Gd, Gd, Ms, Ms, Ms, Xue, Uue, Re, Uhe, Xue, Xue, Ms^Xm, Ms^Xm
Ms^Xm, Ms^Xm, Xue, Uhe, Re, Re, Uhe, Xue, Xue, Xue, Ms^Xm, Gd, Gd, Gd, Gd, Re, Gd, Gd, Gd, Ms, Ms^Xm, Xue, Xue, Re, Uue, Uhe, Ms, Ms^Xm, Ms^Xm
Ms^Xm, Ms^Xm, Ms^Xm, Xue, Uue, Uhe, Re, Uue, Xue, Xue, Ms^Xm, Ms^Xm, Ms, Gd, Gd, Re, Re, Gd, Ms, Ms^Xm, Ms^Xm, Ms^Xm, Ms^Xm, Xue, Xue, Uue, Gd, Ms, Gd
Ms^Xm, Ms^Xm, Ms^Xm, Xue, Uue, Re, Re, Uhe, Xue, Xue, Ms, Ms, Ms, Gd, Gd, Gd, Re, Gd, Gd, Ms, Gd, Ms^Xm, Ms, Ms^Xm, Ms, Gd, Gd, Gd, Gd
Ms^Xm, Ms^Xm, Xue, Xue, Xue, Uue, Uhe, Re, Gd, Gd, Gd, Ms, Gd, Gd, Gd, Gd, Re, Gd, Gd, Gd, Gd, Gd, Gd, Ms, Gd, Gd, Gd, Gd, Gd
Ms^Xm, Ms^Xm, Ms^Xm, Xue, Ms^Xm, Xue, Gd, Gd, Gd, Gd, Gd, Gd, Gd, Gd, Re, Re, Gd, Gd, Gd, Gd, Gd, Gd, Gd, Gd, Gd, Gd, Gd, Gd, Gd
Ms^Xm, Ms^Xm, Ms^Xm, Ms^Xm, Ms^Xm, Gd, Gd, Gd, Gd, Gd, Gd, Re, Gd, Gd, Ms, Gd, Ms, Gd, Gd, Gd, Gd, Gd, Gd, Gd, Gd, Gd, Gd, Gd, Ms
Ms^Xm, Ms^Xm, Ms, Ms^Xm, Gd, Gd, Gd, Gd, Gd, Gd, Re, Re, Gd, Ms, Ms, Ms, Ms, Ms, Gd, Gd, Gd, Gd, Gd, Gd, Gd, Gd, Gd, Ms, Ms^Xm
Gd, Gd, Gd, Gd, Gd, Gd, Gd, Gd, Gd, Gd, Re, Gd, Ms, Ms^Xm, Ms^Xm, Ms, Ms^Xm, Ms, Gd, Gd, Gd, Gd, Ms, Gd, Gd, Gd, Ms, Ms^Xm, Ms^Xm
Gd, Gd, Gd, Gd, Gd, Gd, Gd, Gd, Gd, Gd, Re, Gd, Gd, Ms, Ms^Xm, Ms^Xm, Ms, Gd, Gd, Gd, Ms, Gd, Ms^Xm, Ms, Uue, Ms, Ms, Ms^Xm, Ms^Xm
Gd, Gd, Gd, Gd, Gd, Gd, Gd, Gd, Gd, Gd, Gd, Re, Gd, Ms, Ms, Ms^Xm, Gd, Gd, Gd, Ms, Ms, Ms, Ms^Xm, Xue, Uhe, Uue, Xue, Ms^Xm, Ms^Xm
Ms, Gd, Gd, Gd, Gd, Gd, Gd, Gd, Gd, Gd, Gd, Re, Gd, Gd, Gd, Gd, Gd, Gd, Ms, Ms, Ms^Xm, Ms^Xm, Xue, Xue, Uue, Re, Xue, Ms^Xm, Ms^Xm
Ms^Xm, Ms, Gd, Gd, Gd, Gd, Gd, Gd, Gd, Gd, Gd, Gd, Re, Gd, Gd, Gd, Gd, Ms, Ms, Ms, Xue, Xue, Uue, Re, Uue, Re, Xue, Ms^Xm, Ms^Xm
Ms^Xm, Ms, Ms, Gd, Cva, Gd, Cva, Gd, Gd, Gd, Gd, Gd, Re, Gd, Gd, Gd, Gd, Gd, Ms^Xm, Ms^Xm, Xue, Uhe, Uue, Uhe, Uhe, Xue, Ms^Xm, Ms^Xm, Ms^Xm
Ms^Xm, Ms^Xm, Ha, Aa, Aa, Aa, Gd, Gd, Gd, Gd, Gd, Gd, Re, Gd, Gd, Gd, Ms, Ms, Ms, Ms^Xm, Xue, Xue, Re, Re, Uue, Xue, Ms^Xm, Ms^Xm, Ms^Xm
Ms^Xm, Ms^Xm, Ms, Ha, 4 Kva, Cva^Feta, Aa, Cva, Gd, Gd, Gd, Gd, Re, Gd, Gd, Gd, Gd, Ms, Gd, Xue, Uue, Uue, Re, Uue, Xue, Xue, Ms^Xm, Ms^Xm, Ms^Xm
Ms^Xm, Ms^Xm, Ms^Xm, Ms, Ha, Aa, Cva, Aa, Gd, Gd, Gd, Gd, Gd, Gd, Gd, Gd, Gd, Gd, Gd, Gd, Uhe, Uhe, Re, Uhe, Xue, Ms^Xm, Ms^Xm, Ms^Xm, Ms^Xm
Ms^Xm, Ms^Xm, Ms^Xm, Ms^Xm, Ms^Xm, Ha, Ms, Gd, Gd, Gd, Gd, Gd, Gd, Re, Gd, Gd, Gd, Gd, Gd, Gd, Ms, Xue, Xue, Xue, Ms^Xm, Ms^Xm, Ms^Xm, Ms^Xm, Ms^Xm
Ms^Xm, Ms^Xm, Ms^Xm, Ms^Xm, Ms^Xm, Ms, Ms, Ms, Gd, Gd, Gd, Gd, Gd, Re, Re, Gd, Gd, Gd, Gd, Ms, Ms^Xm, Ms^Xm, Ms^Xm, Ms^Xm, Ms^Xm, Ms^Xm, Ms^Xm, Ms^Xm, Ms^Xm
Ms^Xm, Ms^Xm, Ms^Xm, Ms^Xm, Ms^Xm, Ms^Xm, Ms^Xm, Ha, Gd, Gd, Gd, Gd, Gd, Gd, Gd, Re, Gd, Gd, Gd, Gd, Ms^Xm, Ms^Xm, Ms^Xm, Ms^Xm, Ms^Xm, Ms^Xm, Ms^Xm, Ms^Xm, Ms^Xm
