Gd^Qhu, Gd^Qhu, Aa^Qhu, Aa^Fpa, Aa^Qhuf, Re, Re^Qhu, Aa^Fpa, Aa^Qhuf, Aa^Qhuf, Ww^Qhu, Ww^Qhu, Ww, Ms, Ms, Ms, Ms, Gd, Ms^Xm, Ms^Xm, Ms^Xm, Ms^Xm, Ms^Xm, Ms^Xm
Gd^Qhu, Gd^Qhu, Gd, Gd^Qhu, Gd, Aa^Qhuf, Aa^Fpa, Re^Qhu, Re, Aa^Fpa, Aa^Fpa, Ww^Qhu, Ww^Qhu, Ai, Ai, Ha, Ha, Ms, Ms, Ms, Ms, Ms^Xm, Ms^Xm, Ms^Xm
Aa^Qhuf, Aa^Fpa, Aa^Fpa, Aa^Fpa, Gd^_mll, Aa^Fpa, Aa^Fpa, Gd, Aa, Re, Cea, Aa^Fpa, Aa^Fpa, Re^Qhu, Aa^Qhuf, Aa, Ai, Ha, Ai, Ms, Ms, Ms, Ms, Ms
Aa^Qhuf, Aa^Fpa, Aa^Fpa, Aa^Fpa, Aa^Fpa, Aa^Dr, Aa^Fpa, Gd, Gd, Cea, 1 Kea, Cea, Aa^Fpa, Re, Re, Ww^Qhu, Aa^Vla, Ai, Ha^Qhu, Ai, Ai, Ms, Ha, Ms
Aa^Qhuf, Aa^Dr, Aa^Fpa, Aa^Fda, Aa^Feta, Aa^Fpa, Gd, Aa, Gd, Cea, Cea, Cea, Aa^Fpa, Aa^Fpa, Re, Ww^Qhu, Wwg^Qhu, Aa^Qhu, Aa, Ha^Qhu, Ai^Qhu, Ha, Ha^Qhu, Ha
Gd^Qhu, Gd, Aa^Fpa, Aa^Fda, Aa^Fpa, Aa^Fpa, Aa^Fpa, Gd, Gd, Re, Re, Gd, Gd, Aa^Fpa, Aa^Fpa, Re, Aa, Ai, Aa, Ai, Ai, Ai^Qhu, Ai, Ai^Qhu
Aa^Qhu, Gd, Aa^Fpa, Gd, Gd, Gd, Gd, Gd, Aa, Aa, Aa, Re, Gd, Gd, Gd, Re, Aa, Ai, Ai^Qhu, Aa, Ai, Ai, Ai, Ai^Qhu
Aa^Qhu, Aa, Gd, Gd, Gd, Gd, Aa, Aa, Aa^Qhu, Aa^Qhu, Aa^Qhu, Re, Re, Aa, Aa, Re, Aa^Qhu, Aa^Qhu, Ai, Aa^Qhu, Ai^Qhu, Aa, Ai^Qhu, Ai^Qhu
Aa^Qhu, Aa^Qhu, Gd^Qhu, Gd^Qhu, Gd^Qhu, Gd, Aa^Qhu, Aa^Qhu, Ha, Ha, Aa, Aa^Qhu, Re^Qhu, Aa, Aa^Qhu, Re^Qhu, Gd, Gd, Ww, Aa^Vha, Aa, Ai^Qhu, Ai, Ai
Aa, Aa, Gd, Aa^Fpa, Gd, Gd^Qhu, Gd, Aa, Aa, Gd, Hhd, Hhd, Re, Aa^Qhu, Gd, Re, Re, Ww, Ww, Ai, Ai, Aa, Ai, Ai
Gd, Gd, Aa^Fpa, Aa^Fpa, Gd, Gd, Aa^Fpa, Gd, Gd, Aa^Fpa, Aa^Fpa, Aa^Fpa, Re, Aa, Gd, Aa^Fpa, Aa^Dr, Re, Aa^Fpa, Gd, Aa, Ai, Ww, Ww
Aa^Fpa, Aa^Fpa, Aa^Fpa, Aa^Fpa, Aa^Fpa, Aa^Fpa, Ha, Aa^Fpa, Aa^Fpa, Aa^Fpa, Aa^Vha, Aa^Fpa, Re, Gd, Aa^Fpa, Aa^Fpa, Aa^Fpa, Re, Re, Gd, Aa, Aa, Gd, Aa^Fpa
Aa^Fpa, Aa^Fpa, Ha^Fpa, Aa^Fpa, Aa^Fpa, Ha, Ms^Xm, Ms, Ms, Aa^Fpa, Aa^Fpa, Re, Gd, Aa^Fpa, Gd, Gd, Gd, Aa^Fpa, Re, Gd, Aa, Gd, Gd, Aa^Fpa
Aa^Fpa, Ha^Fpa, Ha^Fpa, Aa^Fpa, Ha, Ms, Ms^Xm, Ms^Xm, Ha, Aa^Fpa, Gd, Re, Aa^Fpa, Aa^Fpa, Aa^Fpa, Gd, Gd, Gd, Aa, Re, Aa, Gd, Gd, Aa^Fpa
Aa^Fpa, Aa^Fpa, Aa^Fpa, Aa^Fpa, Aa^Fpa, Ms, Ha, Ms, Aa^Fpa, Gd, Gd, Re, Gd, Gd, Aa^Fpa, Aa^Fpa, Aa^Fpa, Gd, Gd, Re, Aa^Dr, Aa, Aa, Gd
Aa^Fpa, Gd, Gd, Aa^Fpa, Aa^Fpa, Aa^Fpa, Aa^Fpa, Aa^Fpa, Gd, Aa, Re, Re, Aa^Fpa, Aa^Fpa, Ha^Fpa, Ha, Aa^Fpa, Aa^Fpa, Aa^Fpa, Re, Aa, Aa, Aa, Aa
Aa^Fpa, Aa^Fpa, Aa^Fpa, Gd, Aa^Fpa, Aa^Fpa, Aa^Fpa, Gd, Re, Re, Aa, Gd, Ha^Fpa, Aa^Fpa, Ms, Ha, Ms, Aa^Fpa, Aa^Fpa, Re, Gd, Aa, Aa, Aa
Aa^Fpa, Aa^Fpa, Aa^Fpa, Gd, Re, Re, Re, Re, Aa, Aa, Aa, Aa, Ha^Fpa, Ha, Ms^Xm, Ms^Xm, Ha, Ha^Fpa, Gd, Re, Aa, Aa, Aa, Aa
Aa^Fpa, Gd, Re, Re, Gd, Gd, Gd^Dr, Aa, Aa, Aa, Aa, Aa, Aa^Fpa, Ms, Ms, Ms^Xm, Ms, Ha^Fpa, Aa, Re, Aa, Ha, Ha, Ms
Aa^Fpa, Re, Gd, Gd, Gd, Re, Gd, Gd, Gd, Aa, Aa, Gd, Aa^Fpa, Ha, Ha, Ms, Aa^Fpa, Gd, Re, Re, Aa, Ha, Ms^Xm, Ms^Xm
Re, Re, Gd, Aa^Fpa, Gd, Re, Gd, Gd, Gd, Aa^Fpa, Gd, Aa^Fpa, Aa^Fpa, Ha^Fpa, Aa^Dr, Aa^Fpa, Gd, Aa, Re, Aa^Vha, Aa, Ms, Ms^Xm, Ms^Xm
Re, Aa^Fpa, Aa^Fpa, Aa^Fpa, Aa^Fpa, Gd, Gd, Aa^Fpa, Aa^Fpa, Aa^Fpa, Aa^Fpa, Ww, Ww, Ww, Ww^Dr, Ww^Dr, Gd, Re, Aa, Aa, Ha, Ms, Ms^Xm, Ms^Xm
Aa^Fpa, Aa^Fpa, Aa^Fpa, Aa^Fpa, Aa^Fpa, Re, Aa^Fpa, Aa^Fpa, Aa^Vha, Aa^Fpa, Aa^Fpa, Ww, Ww, Ww, Ww, Ai, Aa, Re, Aa, Aa, Ha, Ha, Ms, Ms^Xm
Aa^Fpa, Aa^Fpa, Aa^Fpa, Aa^Fpa, Aa^Fpa, Re, Re, Aa^Fpa, Aa^Fpa, Aa^Fpa, Gd, Ww, Ww, Ai, Ai, Aa, Aa, Re, Aa, Aa, Aa, Ms, Ms, Ms^Xm
Aa^Fpa, Aa^Fpa, Aa^Fpa, Aa^Fpa, Aa^Fpa, Gd, Gd, Aa^Fpa, Aa^Fpa, Gd, Gd, Aa, Aa, Ai, Ai, Ai, Ai, Re, Aa, Aa, Aa, Aa, Ha, Ms
Aa^Fpa, Aa^Dr, Aa^Fpa, Gd, Gd, Aa, Aa, Re, Re, Aa, Aa, Aa, Aa, Aa, Aa, Aa, Ai, Ww^Bw|, Ww, Gd, Aa^Fpa, Aa^Fpa, Ha, Ha
Aa^Fpa, Aa^Fpa, Gd, Aa, Aa, Aa, Aa, Gd, Gd, Gd, Gd, Aa, Aa, Aa, Aa, Aa, Re, Ww, Ww, Ww, Ww, Ww, Hhd^Dr, Ha
Gll^Fp, Aa^Fpa, Aa, Aa, Aa, Aa, Gd, Gd, Aa^Fpa, Aa^Fpa, Aa^Fpa, Re, Re, Gd, Gd^Vh, Re, Ww, Ww, Ww, Ww, Ww, Ww, Ww, Ha
Gll^Fp, Aa^Fpa, Aa, Aa, Aa, Aa, Gd, Aa^Fpa, Gll^Fp, Gd, Gll^Fp, Ww, Aa^Fpa, Gd, Re, Re, Ww, Ww, Ww, Ww, Ww, Ww, Ww, Ww
Hhd, Gd, Ww, Aa, Aa, Gd, Aa^Fpa, Gll^Fp, Gd, Gd, Gd, Ww, Ai, Aa^Dr, Aa^Fpa, Ww^Bw|, Ww, Ww, Ww, Ww, Ww, Ww, Ww, Ai
Ha, Ai, Ai, Ai, Ai, Ww, Aa^Fpa, Gd, Ww, Gd, Ww, Ai, Ai, Ai, Ms, Re, Ms, Ms, Ms, Ww, Ww, Ww, Ai, Ai
Ms, Ai, Ai, Ww, Ww, Ww, Gll^Fp, Gd, Ww, Ww, Ww, Ha, Ms, Ms^Xm, Ms, Re, Ms, Ms^Xm, Ms^Xm, Ww, Ww, Ww, Ai, Aa
Ms, Ms, Ww, Ww, Ww, Ww, Ww, Gd, Gd^Dr, Ww, Ww, Ha, Ha, Ms, Ms, Re, Cfa, Ms, Ms^Xm, Ms^Xm, Ai, Ai, Ai, Ai
Ms^Xm, Ha^Vhha, Ha, Ww, Ha, Ww, Ww, Gll^Fp, Gd, Ww, Ww, Ai, Ai, Ms, Ms^Xm, Cfa, Cfa, 2 Kfa, Cfa, Ww, Ww, Ai, Ai, Ai
Ms^Xm, Ms^Xm, Ms^Xm, Ms, Ms, Ha, Aa^Fpa, Aa^Fpa, Gll^Fp, Gll^Fp, Gll^Fp, Ww, Ai, Ms, Ms, Ms, Cfa, Cfa, Hhd, Hhd, Ha, Ai, Aa, Aa
Ms, Ms^Xm, Ms, Ms, Ms, Ha, Gd, Aa^Fpa, Gll^Fp, Gll^Fp, Gll^Fp, Ww, Ww, Ai, Hhd, Aa^Fpa, Re, Aa^Fpa, Aa^Vhca, Hhd, Gd, Ai, Ww, Gd
Ms, Ms, Ms, Ms, Ha, Ai, Ww, Aa^Fpa, Aa^Fpa, Aa^Fpa, Aa^Fpa, Ww, Aa^Fpa, Aa^Fpa, Aa^Fpa, Gll^Fp, Re, Gll^Fp, Aa^Fpa, Gd, Aa, Aa, Gd, Aa^Fpa
Aa^Fpa, Aa^Fpa, Aa^Fpa, Aa^Fpa, Gd, Aa, Ww, Aa^Fpa, Aa^Vha, Aa^Fpa, Ww, Ww, Gd, Aa^Fpa, Gll^Fp, Gll^Fp, Re, Aa^Fpa, Gd, Aa, Aa, Aa, Aa^Fpa, Aa^Fpa
Aa^Fpa, Gd, Gd, Gd, Ww, Gd, Ww, Ww, Ww, Ww, Ww, Aa^Fpa, Aa^Dr, Aa^Fpa, Aa^Fpa, Re, Gll^Fp, Aa^Fpa, Gd, Gd, Gd, Gd, Ww, Ww
Aa^Fpa, Gd, Gd, Ww, Ww, Ww, Ww, Ww, Ww, Ww, Aa^Fpa, Aa^Fpa, Aa^Fpa, Aa^Fpa, Aa^Fpa, Re, Aa^Fpa, Gd, Aa, Gd, Ww, Ww, Ww, Ww
Gll^Fp, Aa^Fpa, Ww, Ai, Gd, Ww, Aa^Fpa, Aa^Fpa, Gll^Fp, Aa^Fpa, Aa^Fpa, Gd, Gd, Gd, Gd, Re, Gd, Gd, Ai, Ai, Ww, Ww, Ww, Ww
Ww, Ww, Ww, Ai, Gd, Gd, Aa^Fpa, Aa^Fpa, Aa^Fpa, Aa^Fpa, Aa^Fpa, Gd, Aa, Aa, Re, Re, Aa, Aa, Ai, Gd, Aa^Fpa, Gll^Fp, Ww, Ww
Ww, Ww, Ww, Ai, Aa, Aa, Gd, Gd, Gd, Gd, Aa^Fpa, Gd, Aa, Aa, Re, Aa, Aa, Ww, Gd, Gd, Ww, Gll^Fp, Ww, Ww
Ww, Ww, Ww, Ai, Aa, Aa, Aa, Aa, Aa, Gd, Gd, Gd, Aa, Aa, Re, Aa, Aa, Ai, Gd, Aa^Fpa, Ww, Ww, Ww, Gd
Aa, Ww, Ww, Aa, Aa, Aa, Aa, Aa, Gd, Ha, Ha, Ha, Ha, Aa, Re, Aa, Aa, Ww, Ww, Ww, Ww, Ww, Ww, Aa
Ai, Ww, Gd, Gd, Aa, Aa, Aa, Ha, Hhd, Hhd, Hhd, Hhd, Hhd, Gd, Re, Aa, Gd, Aa^Fpa, Aa^Fpa, Aa^Fpa, Aa^Fpa, Ww, Ww, Ww
Aa, Gd, Aa^Fpa, Aa^Fpa, Gd, Aa, Aa, Ai, Ww, Ms, Ms, Ms, Hhd, Gd^Dr, Re, Aa, Gd, Aa^Fpa, Ww, Aa^Fpa, Ww, Ww, Ww, Gd
Aa, Gd, Aa^Dr, Aa^Fpa, Aa^Fpa, Gd, Ai, Ww, Ww, Ms, Ms, Ms^Xm, Ms^Xm, Aa^Fpa, Re, Aa, Ww, Ww, Ww, Aa^Fpa, Ww, Ww, Aa^Fpa, Ww
Aa, Gd, Aa^Fpa, Aa^Fpa, Aa^Fpa, Gd, Ww, Ww, Ww, Ww, Ww, Ha, Gll^Fp, Aa^Fpa, Re, Ai, Ww, Gd, Aa^Vca, Ww, Ww, Ww, Ww, Gd
Aa, Gd, Aa^Fpa, Aa^Fpa, Gll^Fp, Aa^Fpa, Ww, Ww, Ww, Ww, Ww, Ww, Ww, Aa^Fpa, Ww^Bw|, Ww, Gd, Gd, Gd, Aa^Fpa, Ww, Ww, Gd, Gd
Gd, Aa^Fpa, Aa^Fpa, Aa^Fpa, Aa^Fpa, Aa^Fpa, Ww, Ww, Gll^Fp, Ww, Ww, Ww, Ww, Ww, Re, Ww, Aa^Fpa, Aa^Fpa, Aa^Fpa, Gd, Aa, Aa, Aa, Aa
Aa^Fpa, Gll^Fp, Gll^Fp, Gll^Fp, Aa^Fpa, Gd, Aa^Vha, Aa^Fpa, Gll^Fp, Gll^Fp, Gd, Gd, Gd, Gll^Fp, Re, Aa^Fpa, Gll^Fp, Gll^Fp, Gd, Aa, Aa, Aa, Aa, Aa
Gd, Gll^Fp, Gd, Gll^Fp, Aa^Fpa, Aa^Fpa, Aa^Fpa, Aa^Fpa, Aa^Fpa, Gll^Fp, Gd, Gd, Gll^Fp, Gll^Fp, Re, Gll^Fp, Gd, Aa^Fpa, Gd, Aa, Aa, Aa, Aa, Aa
Gll^Fp, Gd, Gll^Fp, Aa^Fpa, Aa^Fpa, Gd, Aa^Fpa, Gd, Aa^Fpa, Gll^Fp, Gd, Gd, Gll^Fp, Gll^Fp, Re, Gd, Gll^Fp, Aa^Fpa, Gd, Aa, Aa, Aa, Aa, Aa
Gll^Fp, Gll^Fp, Gll^Fp, Aa^Fpa, Gd, Gd, Gd, Gd, Gd, Aa^Fpa, Aa^Fpa, Aa^Fpa, Gll^Fp, Gll^Fp, Re, Gll^Fp, Aa^Fpa, Gd, Aa, Aa, Aa, Gd, Aa, Aa
