Gd, Gd, Aa, Aa^Fpa, Aa^Fpa, Re, Re, Aa^Fpa, Aa^Fpa, Aa^Fpa, Ww, Ww, Ww, Ww, Gd, Gd, Gd, Gd, Gd, Gd, Gd, Hhd, Hhd, Hhd
Gd, Gd, Gd, Gd, Gd, Aa^Fpa, Aa^Fpa, Re, Re, Aa^Fpa, Aa^Fpa, Ww, Ww, Ww^Bw|, Ww, Ww, Ww, Gd, Gd, Gd^Vh, Gd, Hhd, Hhd, Hhd
Aa^Fpa, Aa^Fpa, Aa^Fpa, Aa^Fpa, Gd, Aa^Fpa, Aa^Fpa, Gd, Aa, Re, Gd, Aa^Fpa, Aa^Fpa, Re, Aa^Fpa, Gd, Ww, Ww, Ww, Gd, Gd, Hhd, Hhd, Hhd
Aa^Fpa, Aa^Fpa, Aa^Fpa, Aa^Fpa, Aa^Fpa, Aa^Vha, Aa^Fpa, Gd, Gd, Re, Gd, Gd, Aa^Fpa, Re, Re, Ww, Gd^Vh, Ai, Aa, Ai, Ai, Hhd, Hhd, Mm
Aa^Fpa, Aa^Vha, Aa^Fpa, Ch, 1 Kh, Aa^Fpa, Gd, Aa, Gd, Re, Gd, Gd, Aa^Fpa, Aa^Fpa, Re, Ww, Ai, Aa, Aa, Aa, Ai, Ai, Ai, Ai
Gd, Gd, Aa^Fpa, Gd, Aa^Fpa, Aa^Fpa, Aa^Fpa, Gd, Gd, Re, Re, Gd, Gd, Aa^Fpa, Aa^Fpa, Re, Aa, Ai, Aa, Ai, Ai, Ai, Ai, Ai
Aa, Gd, Aa^Fpa, Gd, Gd, Gd, Gd, Gd, Aa, Aa, Aa, Re, Gd, Gd, Gd, Re, Aa, Ai, Ai, Aa, Ai, Ai, Ai, Ww
Aa, Aa, Gd, Gd, Gd, Gd, Aa, Aa, Aa, Aa, Aa, Re, Re, Aa, Aa, Re, Aa, Aa, Ai, Aa, Ai, Aa, Ai, Ww
Aa, Aa, Gd, Gd, Gd, Gd, Aa, Aa, Ha, Ha, Aa, Aa, Re, Aa, Aa, Re, Gd, Gd, Ww, Aa^Vha, Aa, Ai, Ai, Ww
Aa, Aa, Gd, Aa^Fpa, Gd, Gd, Gd, Aa, Aa, Gd, Hhd, Hhd, Re, Aa, Gd, Re, Re, Ww, Ww, Ai, Ai, Aa, Ai, Ww
Gd, Gd, Aa^Fpa, Aa^Fpa, Gd, Gd, Aa^Fpa, Gd, Gd, Aa^Fpa, Aa^Fpa, Aa^Fpa, Re, Aa, Gd, Aa^Fpa, Aa^Vha, Re, Aa^Fpa, Gd, Aa, Ai, Ww, Ww
Aa^Fpa, Aa^Fpa, Aa^Fpa, Aa^Fpa, Aa^Fpa, Aa^Fpa, Aa^Fpa, Aa^Fpa, Aa^Fpa, Aa^Fpa, Aa^Vha, Aa^Fpa, Re, Gd, Aa^Fpa, Aa^Fpa, Aa^Fpa, Re, Re, Gd, Aa, Aa, Gd, Aa^Fpa
Aa^Fpa, Aa^Fpa, Aa^Fpa, Aa^Fpa, Aa^Fpa, Aa^Fpa, Aa^Fpa, Gll^Fp, Gll^Fp, Aa^Fpa, Aa^Fpa, Re, Gd, Aa^Fpa, Gd, Gd, Gd, Aa^Fpa, Re, Gd, Aa, Gd, Gd, Aa^Fpa
Aa^Fpa, Aa^Fpa, Aa^Fpa, Aa^Fpa, Aa^Fpa, Aa^Fpa, Aa^Fpa, Gll^Fp, Gll^Fp, Aa^Fpa, Gd, Re, Aa^Fpa, Aa^Fpa, Aa^Fpa, Gd, Gd, Gd, Aa, Re, Aa, Gd, Gd, Aa^Fpa
Aa^Fpa, Aa^Fpa, Aa^Fpa, Aa^Fpa, Aa^Fpa, Aa^Fpa, Aa^Fpa, Gll^Fp, Aa^Fpa, Gd, Gd, Re, Gd, Gd, Aa^Fpa, Aa^Fpa, Aa^Fpa, Gd, Gd, Re, Aa^Vha, Aa, Aa, Gd
Aa^Fpa, Gd, Gd, Aa^Fpa, Aa^Fpa, Aa^Fpa, Aa^Fpa, Aa^Fpa, Gd, Aa, Re, Re, Aa^Fpa, Aa^Fpa, Aa^Fpa, Gll^Fp, Aa^Fpa, Aa^Fpa, Aa^Fpa, Re, Aa, Aa, Aa, Aa
Aa^Fpa, Aa^Fpa, Aa^Fpa, Gd, Aa^Fpa, Aa^Fpa, Aa^Fpa, Gd, Re, Re, Aa, Gd, Aa^Fpa, Aa^Fpa, Gll^Fp, Gll^Fp, Gll^Fp, Aa^Fpa, Aa^Fpa, Re, Gd, Aa, Aa, Aa
Aa^Fpa, Aa^Fpa, Aa^Fpa, Gd, Re, Re, Re, Re, Aa, Aa, Aa, Aa, Aa^Fpa, Gll^Fp, Gll^Fp, Gll^Fp, Gll^Fp, Aa^Fpa, Gd, Re, Aa, Aa, Aa, Aa
Aa^Fpa, Gd, Re, Re, Gd, Gd, Gd^Vh, Aa, Aa, Aa, Aa, Aa, Aa^Fpa, Gll^Fp, Gll^Fp, Gll^Fp, Gll^Fp, Aa^Fpa, Aa, Re, Aa, Aa, Aa, Aa
Aa^Fpa, Re, Gd, Gd, Gd, Gd, Gd, Gd, Gd, Aa, Aa, Gd, Aa^Fpa, Gll^Fp, Gll^Fp, Gll^Fp, Aa^Fpa, Gd, Re, Re, Aa, Aa, Aa, Aa
Re, Re, Gd, Aa^Fpa, Gd, Gd, Gd, Gd, Gd, Aa^Fpa, Gd, Aa^Fpa, Aa^Fpa, Aa^Fpa, Aa^Vha, Aa^Fpa, Gd, Aa, Re, Aa^Vha, Aa, Aa, Aa, Gd
Re, Aa^Fpa, Aa^Fpa, Aa^Fpa, Aa^Fpa, Gd, Gd, Aa^Fpa, Aa^Fpa, Aa^Fpa, Aa^Fpa, Ww, Ww, Ww, Ww, Ww, Gd, Re, Aa, Aa, Aa, Aa, Aa, Gd
Aa^Fpa, Aa^Fpa, Aa^Fpa, Aa^Fpa, Aa^Fpa, Gd, Aa^Fpa, Aa^Fpa, Aa^Vha, Aa^Fpa, Aa^Fpa, Ww, Ww, Ww, Ww, Ai, Aa, Re, Aa, Aa, Aa, Aa, Aa, Gd
Aa^Fpa, Aa^Fpa, Aa^Fpa, Aa^Fpa, Aa^Fpa, Gd, Gd, Aa^Fpa, Aa^Fpa, Aa^Fpa, Gd, Ww, Ww, Ai, Ai, Aa, Aa, Re, Aa, Aa, Aa, Aa, Aa, Gd
Aa^Fpa, Aa^Fpa, Aa^Fpa, Aa^Fpa, Aa^Fpa, Gd, Gd, Aa^Fpa, Aa^Fpa, Gd, Gd, Aa, Aa, Ai, Ai, Ai, Ai, Re, Aa, Aa, Aa, Aa, Aa, Gd
Aa^Fpa, Aa^Vha, Aa^Fpa, Gd, Gd, Aa, Aa, Gd, Gd, Aa, Aa, Aa, Aa, Aa, Aa, Aa, Ai, Ww^Bw|, Ww, Gd, Aa^Fpa, Aa^Fpa, Ha, Ha
Aa^Fpa, Aa^Fpa, Gd, Aa, Aa, Aa, Aa, Gd, Gd, Gd, Gd, Aa, Aa, Aa, Aa, Aa, Re, Ww, Ww, Ww, Ww, Ww, Hhd^Vhh, Ha
Gll^Fp, Aa^Fpa, Aa, Aa, Aa, Aa, Gd, Gd, Aa^Fpa, Aa^Fpa, Aa^Fpa, Gd, Gd, Gd, Gd^Vh, Re, Ww, Ww, Ww, Ww, Ww, Ww, Ww, Ha
Gll^Fp, Aa^Fpa, Aa, Aa, Aa, Aa, Gd, Aa^Fpa, Gll^Fp, Gd, Gll^Fp, Ww, Aa^Fpa, Gd, Gd, Re, Ww, Ww, Ww, Ww, Ww, Ww, Ww, Ww
Hhd, Gd, Ww, Aa, Aa, Gd, Aa^Fpa, Gll^Fp, Gd, Gd, Gd, Ww, Ww, Aa^Vha, Aa^Fpa, Ww^Bw|, Ww, Ww, Ww, Ww, Ww, Ww, Ww, Ai
Ha, Ai, Ai, Ai, Ai, Ww, Aa^Fpa, Gd, Ww, Gd, Ww, Ww, Ww, Ww, Hhd, Re, Hhd, Hhd, Ww, Ww, Ww, Ww, Ai, Ai
Ms, Ai, Ai, Ww, Ww, Ww, Gll^Fp, Gd, Ww, Ww, Ww, Ww, Ww, Hhd, Hhd, Re, Hhd, Hhd, Hhd, Ww, Ww, Ww, Ai, Aa
Ms, Ms, Ww, Ww, Ww, Ww, Ww, Gd, Gd^Vh, Ww, Ww, Ww, Ww, Ww, Hhd, Re, Hhd, Ha, Ha, Ha, Ai, Ai, Ai, Ai
Mm, Mm^Vhh, Ww, Ww, Ww, Ww, Ww, Gll^Fp, Gd, Ww, Ww, Ww, Ww, Hhd, Ha, Re, Re, Ha, Ai, Ww, Ww, Ai, Ai, Ai
Mm, Mm, Mm, Mm, Hhd, Ww, Aa^Fpa, Aa^Fpa, Gll^Fp, Gll^Fp, Gll^Fp, Ww, Ww, Hhd, Hhd, Hhd, Re, Gd, Hhd, Hhd, Ha, Ai, Aa, Aa
Mm, Hhd, Mm, Hhd, Hhd, Ww, Gd, Aa^Fpa, Gll^Fp, Gll^Fp, Gll^Fp, Ww, Ww, Ww, Hhd, Aa^Fpa, Re, Aa^Fpa, Aa^Vha, Hhd, Gd, Ai, Ww, Gd
Hhd, Hhd, Hhd, Hhd, Gd, Ai, Ww, Aa^Fpa, Aa^Fpa, Aa^Fpa, Aa^Fpa, Ww, Aa^Fpa, Aa^Fpa, Aa^Fpa, Gll^Fp, Re, Gll^Fp, Aa^Fpa, Gd, Aa, Aa, Gd, Aa^Fpa
Aa^Fpa, Aa^Fpa, Aa^Fpa, Aa^Fpa, Gd, Aa, Ww, Aa^Fpa, Aa^Vha, Aa^Fpa, Ww, Ww, Gd, Aa^Fpa, Gll^Fp, Gll^Fp, Re, Aa^Fpa, Gd, Aa, Aa, Aa, Aa^Fpa, Aa^Fpa
Aa^Fpa, Gd, Gd, Gd, Ww, Gd, Ww, Ww, Ww, Ww, Ww, Aa^Fpa, Aa^Vha, Aa^Fpa, Aa^Fpa, Re, Gll^Fp, Aa^Fpa, Gd, Gd, Gd, Gd, Ww, Ww
Aa^Fpa, Gd, Gd, Ww, Ww, Ww, Ww, Ww, Ww, Ww, Aa^Fpa, Aa^Fpa, Aa^Fpa, Aa^Fpa, Aa^Fpa, Re, Aa^Fpa, Gd, Aa, Gd, Ww, Ww, Ww, Ww
Gll^Fp, Aa^Fpa, Ww, Ai, Gd, Ww, Aa^Fpa, Aa^Fpa, Gll^Fp, Aa^Fpa, Aa^Fpa, Gd, Gd, Gd, Gd, Re, Gd, Gd, Ai, Ai, Ww, Ww, Ww, Ww
Ww, Ww, Ww, Ai, Gd, Gd, Aa^Fpa, Aa^Fpa, Aa^Fpa, Aa^Fpa, Aa^Fpa, Gd, Aa, Aa, Re, Re, Aa, Aa, Ai, Gd, Aa^Fpa, Gll^Fp, Ww, Ww
Ww, Ww, Ww, Ai, Aa, Aa, Gd, Gd, Gd, Gd, Aa^Fpa, Gd, Aa, Aa, Re, Aa, Aa, Ww, Gd, Gd, Ww, Gll^Fp, Ww, Ww
Ww, Ww, Ww, Ai, Aa, Aa, Aa, Aa, Aa, Gd, Gd, Gd, Aa, Aa, Re, Aa, Aa, Ai, Gd, Aa^Fpa, Ww, Ww, Ww, Gd
Aa, Ww, Ww, Aa, Aa, Aa, Aa, Aa, Gd, Ha, Ha, Ha, Ha, Aa, Re, Aa, Aa, Ww, Ww, Ww, Ww, Ww, Ww, Aa
Ai, Ww, Gd, Gd, Aa, Aa, Aa, Ha, Hhd, Hhd, Hhd, Hhd, Hhd, Gd, Re, Aa, Gd, Aa^Fpa, Aa^Fpa, Aa^Fpa, Aa^Fpa, Ww, Ww, Ww
Aa, Gd, Aa^Fpa, Aa^Fpa, Gd, Aa, Aa, Ai, Ww, Mm^Vhh, Mm, Mm, Hhd, Gd^Vh, Re, Aa, Gd, Aa^Fpa, Ww, Aa^Fpa, Ww, Ww, Ww, Gd
Aa, Gd, Aa^Vha, Aa^Fpa, Aa^Fpa, Gd, Ai, Ww, Ww, Ww, Ww, Ch, 2 Kh, Aa^Fpa, Re, Aa, Ww, Ww, Ww, Aa^Fpa, Ww, Ww, Aa^Fpa, Ww
Aa, Gd, Aa^Fpa, Aa^Fpa, Aa^Fpa, Gd, Ww, Ww, Ww, Ww, Ww, Hhd, Gll^Fp, Aa^Fpa, Re, Ai, Ww, Gd, Gd^Vh, Ww, Ww, Ww, Ww, Gd
Aa, Gd, Aa^Fpa, Aa^Fpa, Gll^Fp, Aa^Fpa, Ww, Ww, Ww, Ww, Ww, Ww, Ww, Aa^Fpa, Ww^Bw|, Ww, Gd, Gd, Gd, Aa^Fpa, Ww, Ww, Gd, Gd
Gd, Aa^Fpa, Aa^Fpa, Aa^Fpa, Aa^Fpa, Aa^Fpa, Ww, Ww, Gll^Fp, Ww, Ww, Ww, Ww, Ww, Re, Ww, Aa^Fpa, Aa^Fpa, Aa^Fpa, Gd, Aa, Aa, Aa, Aa
Aa^Fpa, Gll^Fp, Gll^Fp, Gll^Fp, Aa^Fpa, Gd, Aa^Vha, Aa^Fpa, Gll^Fp, Gll^Fp, Gd, Gd, Gd, Gll^Fp, Re, Aa^Fpa, Gll^Fp, Gll^Fp, Gd, Aa, Aa, Aa, Aa, Aa
Gd, Gll^Fp, Gd, Gll^Fp, Aa^Fpa, Aa^Fpa, Aa^Fpa, Aa^Fpa, Aa^Fpa, Gll^Fp, Gd, Gd, Gll^Fp, Gll^Fp, Re, Gll^Fp, Gd, Aa^Fpa, Gd, Aa, Aa, Aa, Aa, Aa
Gll^Fp, Gd, Gll^Fp, Aa^Fpa, Aa^Fpa, Gd, Aa^Fpa, Gd, Aa^Fpa, Gll^Fp, Gd, Gd, Gll^Fp, Gll^Fp, Re, Gd, Gll^Fp, Aa^Fpa, Gd, Aa, Aa, Aa, Aa, Aa
Gll^Fp, Gll^Fp, Gll^Fp, Aa^Fpa, Gd, Gd, Gd, Gd, Gd, Aa^Fpa, Aa^Fpa, Aa^Fpa, Gll^Fp, Gll^Fp, Re, Gll^Fp, Aa^Fpa, Gd, Aa, Aa, Aa, Gd, Aa, Aa
