Gd^Qhu, Gd^Qhu, Aa^Qhu, Aa^Fpa, Aa^Qhuf, Re, Re^Qhu, Aa^Fpa, Aa^Qhuf, Aa^Qhuf, Ww^Qhu, Ww^Qhu, Ww, Ms, Ms, Ms, Ms, Gd, Ms^Xm, Ms^Xm, Ms^Xm, Ms^Xm, Ms^Xm, Ms^Xm
Gd^Qhu, Gd^Qhu, Gd, Gd^Qhu, Gd, Aa^Qhuf, Aa^Fpa, Re^Qhu, Re, Aa^Fpa, Aa^Fpa, Ww^Qhu, Ww^Qhu, Ai, Ai, Ha, Ha, Ms, Ms, Ms, Ms, Ms^Xm, Ms^Xm, Ms^Xm
Aa^Qhuf, Aa^Fpa, Aa^Fpa, Aa^Fpa, Gd^_mll, Aa^Fpa, Aa^Fpa, Gd, Aa, Re, Cea, Aa^Fpa, Aa^Fpa, Re^Qhu, Aa^Qhuf, Aa, Ai, Ha, Ai, Ms, Ms, Ms, Ms, Ms
Aa^Qhuf, Aa^Fpa, Aa^Fpa, Aa^Fpa, Aa^Fpa, Aa^Dr, Aa^Fpa, Gd, Gd, Cea, 1 Kea, Cea, Aa^Fpa, Re, Re, Ww^Qhu, Aa^Vla, Ai, Ha^Qhu, Ai, Ai, Ms, Ha, Ms
Aa^Qhuf, Aa^Dr, Aa^Fpa, Aa^Fda, Aa^Feta, Aa^Fpa, Gd, Aa, Gd, Cea, Cea, Cea, Aa^Fpa, Aa^Fpa, Re, Ww^Qhu, Wwg^Qhu, Aa^Qhu, Aa, Ha^Qhu, Ai^Qhu, Ha, Ha^Qhu, Ha
Gd^Qhu, Gd^Esa, Aa^Fpa, Aa^Fda, Aa^Fpa, Aa^Fpa, Aa^Fpa, Gd, Gd, Re, Re, Gd, Gd^Esa, Aa^Fpa, Aa^Fpa, Re, Aa^Esa, Ai, Aa, Ai^Esa, Ai^Esa, Ai^Qhu, Ai, Ai^Qhu
Aa^Qhu, Gd^Esa, Aa^Fpa, Gd, Gd^Es, Gd, Gd, Gd^Esa, Aa^Esa, Aa^Esa, Aa, Re, Gd, Gd^Esa, Gd, Re, Aa, Ai^Esa, Ai^Qhu, Aa, Ai, Ai, Ai, Ai^Qhu
Aa^Qhu, Aa, Gd, Gd^Esa, Gd^Esa, Gd^Es, Aa, Aa, Aa^Qhu, Aa^Qhu, Aa^Qhu, Re, Re, Aa, Aa, Re, Aa^Qhu, Aa^Qhu, Ai, Aa^Qhu, Ai^Qhu, Aa^Esa, Ai^Qhu, Ai^Qhu
Aa^Qhu, Aa^Qhu, Gd^Qhu, Gd^Qhu, Gd^Qhu, Gd, Aa^Qhu, Aa^Qhu, Ha^Es, Ha^Esa, Aa, Aa^Qhu, Re^Qhu, Aa, Aa^Qhu, Re^Qhu, Gd^Esa, Gd^Esa, Ww^Es, Aa^Vha, Aa, Ai^Qhu, Ai, Ai
Aa, Aa^Esa, Gd^Es, Aa^Fpa, Gd^Esa, Gd^Qhu, Gd, Aa, Aa^Es, Gd^Es, Hhd, Hhd, Re, Aa^Qhu, Gd, Re, Re, Ww^Es, Ww^Es, Ai^Esa, Ai, Aa, Ai, Ai
Gd, Gd^Esa, Aa^Fpa, Aa^Fpa, Gd, Gd, Aa^Fpa, Gd^Esa, Gd^Esa, Aa^Fpa, Aa^Fpa, Aa^Fpa, Re, Aa, Gd, Aa^Fpa, Aa^Dr, Re, Aa^Fpa, Gd^Esa, Aa^Esa, Ai, Ww, Ww
Aa^Fpa, Aa^Fpa, Aa^Fpa, Aa^Fpa, Aa^Fpa, Aa^Fpa, Ha, Aa^Fpa, Aa^Fpa, Aa^Fpa, Aa^Vha, Aa^Fpa, Re, Gd, Aa^Fpa, Aa^Fpa, Aa^Fpa, Re, Re, Gd, Aa, Aa, Gd, Aa^Fpa
Aa^Fpa, Aa^Fpa, Ha^Fpa, Aa^Fpa, Aa^Fpa, Ha, Ms^Xm, Ms, Ms, Aa^Fpa, Aa^Fpa, Re, Gd, Aa^Fpa, Gd, Gd^Es, Gd^Esa, Aa^Fpa, Re, Gd^Esa, Aa^Es, Gd, Gd, Aa^Fpa
Aa^Fpa, Ha^Fpa, Ha^Fpa, Aa^Fpa, Ha, Ms, Ms^Xm, Ms^Xm, Ha, Aa^Fpa, Gd^Esa, Re, Aa^Fpa, Aa^Fpa, Aa^Fpa, Gd^Esa, Gd, Gd, Aa, Re, Aa, Gd^Es, Gd, Aa^Fpa
Aa^Fpa, Aa^Fpa, Aa^Fpa, Aa^Fpa, Aa^Fpa, Ms, Ha, Ms, Aa^Fpa, Gd^Esa, Gd, Re, Gd, Gd, Aa^Fpa, Aa^Fpa, Aa^Fpa, Gd, Gd, Re, Aa^Dr, Aa, Aa^Es, Gd
Aa^Fpa, Gd^Es, Gd^Es, Aa^Fpa, Aa^Fpa, Aa^Fpa, Aa^Fpa, Aa^Fpa, Gd, Aa, Re, Re, Aa^Fpa, Aa^Fpa, Ha^Fpa, Ha, Aa^Fpa, Aa^Fpa, Aa^Fpa, Re, Aa, Aa, Aa^Es, Aa
Aa^Fpa, Aa^Fpa, Aa^Fpa, Gd^Esa, Aa^Fpa, Aa^Fpa, Aa^Fpa, Gd, Re, Re, Aa, Gd, Ha^Fpa, Aa^Fpa, Ms, Ha, Ms, Aa^Fpa, Aa^Fpa, Re, Gd^Esa, Aa^Esa, Aa, Aa
Aa^Fpa, Aa^Fpa, Aa^Fpa, Gd, Re, Re, Re, Re, Aa, Aa^Es, Aa^Es, Aa, Ha^Fpa, Ha, Ms^Xm, Ms^Xm, Ha, Ha^Fpa, Gd, Re, Aa, Aa^Esa, Aa, Aa
Aa^Fpa, Gd, Re^Esa, Re, Gd, Gd^Esa, Gd^Dr, Aa, Aa^Esa, Aa^Esa, Aa, Aa^Esa, Aa^Fpa, Ms, Ms, Ms^Xm, Ms, Ha^Fpa, Aa, Re, Aa, Ha, Ha, Ms
Aa^Fpa, Re, Gd, Gd^Esa, Gd, Re, Gd, Gd, Gd, Aa, Aa, Gd, Aa^Fpa, Ha, Ha, Ms, Aa^Fpa, Gd, Re, Re, Aa, Ha, Ms^Xm, Ms^Xm
Re, Re, Gd, Aa^Fpa, Gd, Re, Gd, Gd, Gd, Aa^Fpa, Gd, Aa^Fpa, Aa^Fpa, Ha^Fpa, Aa^Dr, Aa^Fpa, Gd^Esa, Aa^Esa, Re, Aa^Vha, Aa, Ms, Ms^Xm, Ms^Xm
Re, Aa^Fpa, Aa^Fpa, Aa^Fpa, Aa^Fpa, Gd, Gd, Aa^Fpa, Aa^Fpa, Aa^Fpa, Aa^Fpa, Ww, Ww, Ww, Ww^Dr, Ww^Dr, Gd, Re, Aa, Aa, Ha, Ms, Ms^Xm, Ms^Xm
Aa^Fpa, Aa^Fpa, Aa^Fpa, Aa^Fpa, Aa^Fpa, Re, Aa^Fpa, Aa^Fpa, Aa^Vha, Aa^Fpa, Aa^Fpa, Ww, Ww, Ww, Ww, Ai, Aa^Esa, Re, Aa^Esa, Aa^Esa, Ha, Ha, Ms, Ms^Xm
Aa^Fpa, Aa^Fpa, Aa^Fpa, Aa^Fpa, Aa^Fpa, Re, Re, Aa^Fpa, Aa^Fpa, Aa^Fpa, Gd^Es, Ww, Ww, Ai, Ai, Aa^Esa, Aa, Re, Aa, Aa, Aa^Esa, Ms, Ms, Ms^Xm
Aa^Fpa, Aa^Fpa, Aa^Fpa, Aa^Fpa, Aa^Fpa, Gd, Gd, Aa^Fpa, Aa^Fpa, Gd, Gd^Esa, Aa^Es, Aa^Esa, Ai^Esa, Ai, Ai^Esa, Ai, Re, Aa, Aa^Esa, Aa, Aa, Ha, Ms
Aa^Fpa, Aa^Dr, Aa^Fpa, Gd, Gd, Aa, Aa, Re, Re, Aa, Aa^Esa, Aa, Aa^Esa, Aa^Esa, Aa, Aa, Ai, Ww^Bw|, Ww, Gd^Es, Aa^Fpa, Aa^Fpa, Ha^Esa, Ha
Aa^Fpa, Aa^Fpa, Gd, Aa, Aa, Aa, Aa^Esa, Gd, Gd, Gd^Esa, Gd, Aa, Aa, Aa, Aa, Aa, Re, Ww, Ww, Ww, Ww, Ww, Hhd^Dr, Ha
Gll^Fp, Aa^Fpa, Aa, Aa, Aa^Es, Aa^Esa, Gd^Esa, Gd, Aa^Fpa, Aa^Fpa, Aa^Fpa, Re, Re, Gd, Gd^Vh, Re, Ww, Ww, Ww^Es, Ww^Es, Ww, Ww, Ww, Ha
Gll^Fp, Aa^Fpa, Aa, Aa^Es, Aa, Aa, Gd, Aa^Fpa, Gll^Fp, Gd, Gll^Fp, Ww, Aa^Fpa, Gd, Re, Re, Ww, Ww, Ww, Ww, Ww, Ww, Ww, Ww
Hhd, Gd, Ww, Aa, Aa, Gd, Aa^Fpa, Gll^Fp, Gd, Gd^Esa, Gd^Esa, Ww, Ai, Aa^Dr, Aa^Fpa, Ww^Bw|, Ww, Ww, Ww, Ww, Ww, Ww, Ww, Ai
Ha, Ai, Ai^Esa, Ai, Ai, Ww, Aa^Fpa, Gd, Ww, Gd^Esa, Ww, Ai, Ai, Ai, Ms, Re, Ms, Ms, Ms, Ww, Ww, Ww, Ai, Ai
Ms, Ai^Esa, Ai, Ww, Ww, Ww, Gll^Fp, Gd^Esa, Ww, Ww, Ww, Ha, Ms, Ms^Xm, Ms, Re^Esa, Ms, Ms^Xm, Ms^Xm, Ww, Ww, Ww, Ai, Aa
Ms, Ms, Ww, Ww, Ww, Ww, Ww^Es, Gd^Es, Gd^Dr, Ww, Ww, Ha, Ha, Ms, Ms, Re, Cfa^Esa, Ms, Ms^Xm, Ms^Xm, Ai, Ai, Ai, Ai
Ms^Xm, Ha^Vhha, Ha, Ww, Ha^Esa, Ww, Ww^Es, Gll^Fp, Gd^Esa, Ww, Ww, Ai^Esa, Ai^Esa, Ms, Ms^Xm, Cfa^Esa, Cfa, 2 Kfa, Cfa, Ww, Ww, Ai, Ai, Ai
Ms^Xm, Ms^Xm, Ms^Xm, Ms, Ms, Ha^Esa, Aa^Fpa, Aa^Fpa, Gll^Fp, Gll^Fp, Gll^Fp, Ww^Es, Ai, Ms, Ms, Ms, Cfa, Cfa, Hhd^Esa, Hhd, Ha, Ai, Aa, Aa
Ms, Ms^Xm, Ms, Ms, Ms, Ha, Gd, Aa^Fpa, Gll^Fp, Gll^Fp, Gll^Fp, Ww, Ww, Ai, Hhd, Aa^Fpa, Re, Aa^Fpa, Aa^Vhca, Hhd^Esa, Gd^Es, Ai, Ww, Gd
Ms, Ms, Ms, Ms, Ha, Ai, Ww, Aa^Fpa, Aa^Fpa, Aa^Fpa, Aa^Fpa, Ww, Aa^Fpa, Aa^Fpa, Aa^Fpa, Gll^Fp, Re, Gll^Fp, Aa^Fpa, Gd^Esa, Aa^Esa, Aa, Gd, Aa^Fpa
Aa^Fpa, Aa^Fpa, Aa^Fpa, Aa^Fpa, Gd, Aa, Ww, Aa^Fpa, Aa^Vha, Aa^Fpa, Ww, Ww, Gd^Esa, Aa^Fpa, Gll^Fp, Gll^Fp, Re, Aa^Fpa, Gd^Esa, Aa, Aa, Aa, Aa^Fpa, Aa^Fpa
Aa^Fpa, Gd, Gd, Gd, Ww, Gd, Ww, Ww, Ww, Ww, Ww, Aa^Fpa, Aa^Dr, Aa^Fpa, Aa^Fpa, Re, Gll^Fp, Aa^Fpa, Gd, Gd^Esa, Gd, Gd, Ww, Ww
Aa^Fpa, Gd, Gd, Ww, Ww, Ww, Ww, Ww, Ww, Ww, Aa^Fpa, Aa^Fpa, Aa^Fpa, Aa^Fpa, Aa^Fpa, Re, Aa^Fpa, Gd^Esa, Aa^Es, Gd, Ww, Ww, Ww, Ww
Gll^Fp, Aa^Fpa, Ww, Ai, Gd, Ww, Aa^Fpa, Aa^Fpa, Gll^Fp, Aa^Fpa, Aa^Fpa, Gd, Gd, Gd, Gd, Re, Gd, Gd^Esa, Ai, Ai, Ww, Ww, Ww, Ww
Ww, Ww, Ww, Ai, Gd, Gd, Aa^Fpa, Aa^Fpa, Aa^Fpa, Aa^Fpa, Aa^Fpa, Gd, Aa, Aa, Re, Re, Aa, Aa, Ai^Esa, Gd^Esa, Aa^Fpa, Gll^Fp, Ww, Ww
Ww, Ww, Ww, Ai, Aa, Aa, Gd, Gd, Gd^Esa, Gd, Aa^Fpa, Gd, Aa^Esa, Aa^Esa, Re, Aa, Aa^Es, Ww, Gd, Gd^Es, Ww, Gll^Fp, Ww, Ww
Ww, Ww, Ww, Ai, Aa^Es, Aa^Es, Aa^Esa, Aa^Esa, Aa, Gd, Gd, Gd, Aa, Aa, Re, Aa^Es, Aa, Ai, Gd^Esa, Aa^Fpa, Ww, Ww, Ww, Gd
Aa, Ww, Ww, Aa, Aa, Aa, Aa, Aa, Gd, Ha, Ha, Ha, Ha, Aa, Re, Aa^Esa, Aa, Ww, Ww, Ww, Ww, Ww, Ww, Aa
Ai, Ww, Gd^Esa, Gd, Aa^Esa, Aa^Esa, Aa^Esa, Ha, Hhd, Hhd, Hhd, Hhd, Hhd^Es, Gd, Re^Esa, Aa, Gd, Aa^Fpa, Aa^Fpa, Aa^Fpa, Aa^Feta, Ww, Ww, Ww
Aa, Gd^Esa, Aa^Fpa, Aa^Fpa, Gd, Aa, Aa^Es, Ai, Ww, Ms, Ms, Ms, Hhd, Gd^Dr, Re, Aa, Gd, Aa^Fpa, Ww, Aa^Fpa, Ww, Ww, Ww, Gd
Aa, Gd^Es, Aa^Dr, Aa^Fpa, Aa^Fpa, Gd^Es, Ai, Ww, Ww, Ms, Ms, Ms^Xm, Ms^Xm, Aa^Fpa, Re, Aa, Ww, Ww, Ww, Aa^Fpa, Ww, Ww, Aa^Fpa, Ww
Aa, Gd, Aa^Fpa, Aa^Fpa, Aa^Fpa, Gd, Ww, Ww, Ww, Ww, Ww, Ha, Gll^Fp, Aa^Fpa, Re, Ai, Ww, Gd, Aa^Vca, Ww, Ww, Ww, Ww, Gd
Aa, Gd, Aa^Fpa, Aa^Fpa, Gll^Fp, Aa^Fpa, Ww, Ww, Ww, Ww, Ww, Ww, Ww, Aa^Fpa, Ww^Bw|, Ww, Gd^Esa, Gd^Esa, Gd, Aa^Fpa, Ww, Ww, Gd^Esa, Gd
Gd, Aa^Fpa, Aa^Fpa, Aa^Fpa, Aa^Fpa, Aa^Fpa, Ww, Ww, Gll^Fp, Ww, Ww^Es, Ww^Es, Ww, Ww, Re, Ww, Aa^Fpa, Aa^Fpa, Aa^Fpa, Gd, Aa, Aa^Es, Aa, Aa
Aa^Fpa, Gll^Fp, Gll^Fp, Gll^Fp, Aa^Fpa, Gd^Es, Aa^Vha, Aa^Fpa, Gll^Fp, Gll^Fp, Gd^Esa, Gd^Esa, Gd, Gll^Fp, Re, Aa^Fpa, Gll^Fp, Gll^Fp, Gd, Aa, Aa, Aa, Aa, Aa
Gd, Gll^Fp, Gd^Esa, Gll^Fp, Aa^Fpa, Aa^Fpa, Aa^Fpa, Aa^Fpa, Aa^Fpa, Gll^Fp, Gd, Gd, Gll^Fp, Gll^Fp, Re, Gll^Fp, Gd, Aa^Fpa, Gd^Esa, Aa^Esa, Aa, Aa, Aa, Aa
Gll^Fp, Gd^Esa, Gll^Fp, Aa^Fpa, Aa^Fpa, Gd, Aa^Fpa, Gd^Esa, Aa^Fpa, Gll^Fp, Gd, Gd, Gll^Fp, Gll^Fp, Re, Gd, Gll^Fp, Aa^Fpa, Gd, Aa, Aa, Aa, Aa, Aa
Gll^Fp, Gll^Fp, Gll^Fp, Aa^Fpa, Gd, Gd, Gd, Gd, Gd, Aa^Fpa, Aa^Fpa, Aa^Fpa, Gll^Fp, Gll^Fp, Re, Gll^Fp, Aa^Fpa, Gd, Aa, Aa, Aa, Gd, Aa, Aa
