Ai, Ai, Wog, Wog, Ai, Ms^Xm, Ms^Xm, Ms, Ha, Aa, Aa, Aa, Aa, Rd, Rd^Esa, Gs, Gs, Aa^Qhh, Aa^Fda, Aa, Ms, Ms, Ms^Xm, Ms^Xm, Ms^Xm, Gd, Ms^Xm, Ms^Xm, Ms^Xm
Ai, Ai, Wog, Ai, Ms^Xm, Ms^Xm, Ms, Ms, Ha, Aa^Esa, Aa^Fma, Aa, Gs^Es, Aa^Esa, Aa, Gd, Gd^Es, Aa^Qhhf, Aa^Fma, Aa, Ha^Esa, Ms, Xue, Ms^Xm, Ms^Xm, Ms^Xm, Ms^Xm, Ms^Xm, Ms^Xm
Wog, Wog, Wwg, Ms^Xm, Ai, Ms, Aa^Fpa, Ha^Fda, Gd, Aa^Fpa, Aa^Fda, Gs, Rd, Cea, 1 Kea, Cea, Aa^Vla, Aa^Qhh, Gd, Gd^Esa, Ha, Uue, Uue^Tf, Xue, Ms^Xm, Ms^Xm, Ms^Xm, Ms^Xm, Ms^Xm
Wog, Wog, Ai, Wwg, Wwrg, Aa, Ms, Gd^Esa, Gd, Aa, Aa, Gs, Rd^Esa, Cea, Gd, Cea, Aa^Qhh, Aa^Qhh, Ms, Ha, Xue, Uhe, Re, Xue, Xue, Ms^Xm, Ms^Xm, Ms^Xm, Ms^Xm
Ms^Xm, Ms, Ms, Ha^Fma, Ha^Es, Ms, Ms^Xm, Ms, Ms, Aa^Vla, Ha^Es, Aa^Esa, Aa^Esa, Rd, Gs, Gs, Ha^Qhh, Ms, Ms^Xm, Ms^Xm, Xue, Uhe^Tf, Re, Uue, Uue^Tf, Xue, Ms^Xm, Ms^Xm, Ms^Xm
Ms^Xm, Ms^Xm, Xue, Ha^Esa, Uue^Tf, Xue, Xue, Ms, Ms, Ha^Esa, Ha^Fda, Ha^Fda, Aa^Fpa, Rd^Es, Aa, Aa^Fpa, Aa^Qhhf, Ms, Ms^Xm, Ms^Xm, Ms^Xm, Xue, Uhe, Uhe^Tf, Uue, Xue, Ms^Xm, Ms^Xm, Ms^Xm
Ms^Xm, Ms^Xm, Xue, Uhe, Uue, Xue, Xue, Ms, Ms, Ms, Ms^Xm, Ha^Fpa, Aa, Aa^Es, Gd, Aa^Fda, Aa^Qhhf, Ha, Ha^Fda, Ms, Ms^_mh, Xue, Uue^Tf, Re, Uhe, Xue, Xue, Ms^Xm, Ms^Xm
Ms^Xm, Ms^Xm, Xue, Uhe^Tf, Re, Re, Uhe, Xue, Xue, Xue, Ms^Xm, Ha, Ha, Gd, Gs^Esa, Rd^Esa, Aa, Aa^Qhh, Aa^Fda, Ms, Ms^Xm, Xue, Xue, Re, Uue^Tf, Uhe, Ms, Ms^Xm, Ms^Xm
Ms^Xm, Ms^Xm, Ms^Xm, Xue, Uue^Tf, Uhe, Re, Uue, Xue, Xue, Ms^Xm, Ms^Xm, Ms, Gs, Aa^Fma, Rd, Rd, Aa^Qhhf, Ms, Ms^Xm, Ms^Xm, Ms^Xm, Ms^Xm, Xue, Xue, Uue, Ha^Qhh, Ms, Ha^Qhh
Ms^Xm, Ms^Xm, Ms^Xm, Xue, Uue^Tf, Re^Tf, Re, Uhe^Tf, Xue, Xue, Ms, Ms, Ms, Aa^Fda, Aa^Fpa, Ha^Es, Ha^Fpa, Gd^Qhh, Ha, Ms, Ha, Ms^Xm, Ms, Ms^Xm, Ms, Ha^Qhh, Aa, Aa^Qhh, Aa
Ms^Xm, Ms^Xm, Xue, Xue, Xue, Uue, Uhe^Tf, Re, Ha, Ha, Ms, Ms, Ha^Fda, Aa, Aa^Esa, Aa^Es, Rd, Gd^Qhh, Aa^Qhh, Ha, Aa^Qhhf, Aa^Qhh, Ha^Qhh, Ms, Aa^Qhhf, Aa^Qhhf, Gd, Gd, Aa^Qhh
Ms^Xm, Ms^Xm, Ms^Xm, Xue, Ms^Xm, Xue, Aa^Esa, Ha, Gd^Esa, Aa^Esa, Aa, Ha^Fpa, Gs, Gs, Rd, Rd, Ha, Gd^Esa, Gd, Aa^Qhhf, Aa^Fda, Aa, Aa^Esa, Ha^Qhh, Aa^Fma, Aa^Fda, Gd^Qhh, Gd^Qhh, Ha
Ms^Xm, Ms^Xm, Ms^Xm, Ms^Xm, Ms^Xm, Ms, Ha^Es, Aa, Aa, Gd, Aa^Fda, Rd^Esa, Aa, Aa, Qxu, Ha, Qxu, Gd^Esa, Ha, Aa, Aa^Fpa, Aa^Fda, Aa, Gd^Esa, Gd, Aa^Qhhf, Aa, Ha, Ms
Ms^Xm, Ms^Xm, Ha^Dr, Ms^Xm, Ha, Ha^Es, Ai^Qhux, Gd, Gd, Aa^Fpa, Rd, Rd, Aa^Fda, Qxu, Qxu, Qxu, Qxu, Qxu, Ha, Gd, Gs^Qhh, Aa^Qhhf, Aa^Qhh, Gd, Aa^Qhh, Aa^Qhh, Ha, Ms, Ms^Xm
Ai^Qhux, Aa, Aa, Aa^Es, Ai^Qhux, Ai^Qhux, Ha, Aa, Gs, Gs, Rd, Ha^Fpa, Ms, Ms^Xm, Ms^Xm, Qxu, Ms^Xm, Ms, Aa^Qhh, Gs^Qhh, Gs, Aa, Ms, Aa^Qhh, Ha, Aa, Ms, Ms^Xm, Ms^Xm
Ai^Qhux, Ai^Qhux, Ai^Qhux, Ai^Qhux, Ai^Qhux, Ai^Qhux, Ha, Aa, Aa, Aa, Rd, Ha^Es, Ha^Fda, Ms, Ms^Xm, Ms^Xm, Ms, Ha, Rd^Qhh, Aa^Fma, Ha^Fma, Aa^Vla, Ms^Xm, Ms, Uue, Ms, Ms, Ms^Xm, Ms^Xm
Ai^Qhux, Aa, Aa, Ai^Qhux, Aa, Aa, Gs, Ha, Re, Aa, Aa, Rd, Gd^Esa, Ms, Ms, Ms^Xm, Ha, Ha, Rd^Qhh, Ha^Fda, Ms, Ms, Ms^Xm, Xue, Uhe, Uue, Xue, Ms^Xm, Ms^Xm
Ha, Ha, Aa^Fpa, Aa, Aa^Fpa, Gs^Esa, Gd^Esa, Re, Re, Gd, Gd, Rd, Gs, Gd^Esa, Aa^Fma, Aa^Es, Aa^Qhh, Rd^Qhh, Ms, Ha, Ms^Xm, Ms^Xm, Xue, Xue, Uue, Re, Xue, Ms^Xm, Ms^Xm
Ms^Xm, Ms, Ha^Fpa, Ha^Fpa, Ha^Qhh, Gd^Esa, Aa^Qhh, Re, Ha, Ha, Gs, Gs, Rd, Gd^Es, Aa^Qhhf, Aa^Qhhf, Ha^Fpa, Ms, Ms, Ms, Xue, Xue, Uue^Tf, Re, Uue^Tf, Re^Tf, Xue, Ms^Xm, Ms^Xm
Ms^Xm, Ms, Ha, Ha^Qhh, Cva, Ha^Qhh, Cva, Aa^Qhh, Aa^Qhh, Ha, Aa, Aa, Rd, Aa, Gd^Qhh, Aa^Fda, Ha^Fpa, Aa^Vea, Ms^Xm, Ms^Xm, Xue, Uhe, Uue, Uhe, Uhe, Xue, Qxu, Ms^Xm, Ms^Xm
Ms^Xm, Ms^Xm, Ha, Aa^Qhh, Rra^Vea, Cva, Ha^Fpa, Ha, Aa^Qhh, Gd, Gd, Gd, Rd, Aa, Gd^Qhh, Gd^Esa, Ms, Ms, Ms, Ms^Xm, Xue, Xue, Re, Re, Uue^Tf, Xue, Qxu, Ms^Xm, Ms^Xm
Ms^Xm, Ms^Xm, Ha, Ha^Qhh, 2 Kva, Cva^Feta, Cva^_mhh, Cva, Aa^Qhh, Ha, Gs, Gs, Rd, Aa, Aa, Aa^Qhh, Aa^Fma, Ms, Ha^Esa, Xue, Uue, Uue^Tf, Re, Uue, Xue, Xue, Qxu, Ms^Xm, Ms^Xm
Ms^Xm, Ms^Xm, Ms^Xm, Ha^Qhh, Ha^Qhh, Rra^Vea, Cva, Aa^Qhh, Ha, Aa, Aa, Aa, Gd, Gs^Esa, Aa^Es, Aa^Qhhf, Aa^Fda, Ha, Aa^Fpa, Ha^Fda, Uhe, Uhe, Re, Uhe, Xue, Qxu^_mh, Ms^Xm, Ms^Xm, Ms^Xm
Ms^Xm, Ms^Xm, Ms, Ms^Xm, Ms^Xm, Ha^Qhh, Ha^Qhh, Ha^Qhh, Aa, Aa, Aa^Fpa, Aa^Fpa, Aa^Fda, Gs^Esa, Aa^Esa, Aa^Qhhf, Gs, Aa, Ha^Fda, Aa, Ms, Xue, Xue, Xue, Qxu, Qxu, Ms^Xm, Ms^Xm, Ms^Xm
Ms^Xm, Ms^Xm, Ms^Xm, Ms^Xm, Ms^Xm, Ms, Ms, Ms, Aa, Aa, Gd, Aa^Fda, Aa^Fma, Aa^Fpa, Rd, Gs^Qhh, Gs^Qhh, Ha^Fma, Ha, Ms, Ms^Xm, Ms^Xm, Ms^Xm, Qxu, Ms^Xm, Ms^Xm, Ms^Xm, Ms^Xm, Ms^Xm
Ms^Xm, Ms^Xm, Ms^Xm, Ms^Xm, Ms^Xm, Ms^Xm, Ms^Xm, Ha, Aa, Aa, Gd, Gd^Es, Aa, Aa, Aa, Rd, Gd, Aa^Qhh, Aa, Aa, Ms^Xm, Ms^Xm, Ms^Xm, Ms^Xm, Ms^Xm, Ms^Xm, Ms^Xm, Ms^Xm, Ms^Xm
