Ai, Ai, Wog, Wog, Ai, Ms^Xm, Ms^Xm, Ms, Ha, Aa, Aa, Aa, Aa, Rd, Rd^Esa, Gd, Gd, Aa^Qhh, Aa^Fda, Aa, Ms, Ms, Ms^Xm, Ms^Xm, Ms^Xm, Gd, Ms^Xm, Ms^Xm, Ms^Xm
Ai, Ai, Wog, Ai, Ms^Xm, Ms^Xm, Ms, Ms, Ha, Aa^Esa, Aa^Fma, Aa, Gd^Es, Aa^Esa, Aa, Gd, Gd^Es, Aa^Qhhf, Aa^Fma, Aa, Ha^Esa, Ms, Xue, Ms^Xm, Ms^Xm, Ms^Xm, Ms^Xm, Ms^Xm, Ms^Xm
Wog, Wog, Wwg, Ms^Xm, Ai, Ms, Aa^Fpa, Ha^Fda, Gd, Aa^Fpa, Aa^Fda, Gd, Rd, Cea, 1 Kea, Cea, Aa^Vla, Aa^Qhh, Gd, Gd^Esa, Ha, Uue, Uue^Tf, Xue, Ms^Xm, Ms^Xm, Ms^Xm, Ms^Xm, Ms^Xm
Wog, Wog, Ai, Wwg, Wwrg, Aa, Ms, Gd^Esa, Gd, Aa, Aa, Gd, Rd^Esa, Cea, Gd, Cea, Aa^Qhh, Aa^Qhh, Ms, Ha, Xue, Uhe, Re, Xue, Xue, Ms^Xm, Ms^Xm, Ms^Xm, Ms^Xm
Ms^Xm, Ms, Ms, Ha^Fma, Ha^Es, Ms, Ms^Xm, Ms, Ms, Aa^Vla, Ha^Es, Aa^Esa, Aa^Esa, Rd, Gd, Gd^Es, Ha^Qhh, Ms, Ms^Xm, Ms^Xm, Xue, Uhe^Tf, Re, Uue, Uue^Tf, Xue, Ms^Xm, Ms^Xm, Ms^Xm
Ms^Xm, Ms^Xm, Xue, Ha^Esa, Uue^Tf, Xue, Xue, Ms, Ms, Ha^Esa, Ha^Fda, Ha^Fda, Aa^Fpa, Rd^Es, Aa, Aa^Fpa, Aa^Qhhf, Ms, Ms^Xm, Ms^Xm, Ms^Xm, Xue, Uhe, Uhe^Tf, Uue, Xue, Ms^Xm, Ms^Xm, Ms^Xm
Ms^Xm, Ms^Xm, Xue, Uhe, Uue, Xue, Xue, Ms, Ms, Ms, Ms^Xm, Ha^Fpa, Aa, Aa^Es, Gd, Aa^Fda, Aa^Qhhf, Ha, Ha^Fda, Ms, Ms^_mh, Xue, Uue^Tf, Re, Uhe, Xue, Xue, Ms^Xm, Ms^Xm
Ms^Xm, Ms^Xm, Xue, Uhe^Tf, Re, Re, Uhe, Xue, Xue, Xue, Ms^Xm, Ha, Ha, Gd, Gd^Esa, Rd^Esa, Aa, Aa^Qhh, Aa^Fda, Ms, Ms^Xm, Xue, Xue, Re, Uue^Tf, Uhe, Ms, Ms^Xm, Ms^Xm
Ms^Xm, Ms^Xm, Ms^Xm, Xue, Uue^Tf, Uhe, Re, Uue, Xue, Xue, Ms^Xm, Ms^Xm, Ms, Gd, Aa^Fma, Rd, Rd, Aa^Qhhf, Ms, Ms^Xm, Ms^Xm, Ms^Xm, Ms^Xm, Xue, Xue, Uue, Ha^Qhh, Ms, Ha^Qhh
Ms^Xm, Ms^Xm, Ms^Xm, Xue, Uue^Tf, Re^Tf, Re, Uhe^Tf, Xue, Xue, Ms, Ms, Ms, Aa^Fda, Aa^Fpa, Ha^Es, Ha^Fpa, Gd^Qhh, Ha, Ms, Ha, Ms^Xm, Ms, Ms^Xm, Ms, Ha^Qhh, Aa, Aa^Qhh, Aa
Ms^Xm, Ms^Xm, Xue, Xue, Xue, Uue, Uhe^Tf, Re, Ha, Ha, Ms, Ms, Ha^Fda, Aa, Aa^Esa, Aa^Es, Rd, Gd^Qhh, Aa^Qhh, Ha, Aa^Qhhf, Aa^Qhh, Ha^Qhh, Ms, Aa^Qhhf, Aa^Qhhf, Gd, Gd, Aa^Qhh
Ms^Xm, Ms^Xm, Ms^Xm, Xue, Ms^Xm, Xue, Aa^Esa, Ha, Gd^Esa, Aa^Esa, Aa, Ha^Fpa, Gd^Esa, Gd, Rd, Rd, Ha, Gd^Esa, Gd, Aa^Qhhf, Aa^Fda, Aa, Aa^Esa, Ha^Qhh, Aa^Fma, Aa^Fda, Gd^Qhh, Gd^Qhh, Ha
Ms^Xm, Ms^Xm, Ms^Xm, Ms^Xm, Ms^Xm, Ms, Ha^Es, Aa, Aa, Gd, Aa^Fda, Rd^Esa, Aa, Aa, Qxu, Ha, Qxu, Gd^Esa, Ha, Aa, Aa^Fpa, Aa^Fda, Aa, Gd^Esa, Gd, Aa^Qhhf, Aa, Ha, Ms
Ms^Xm, Ms^Xm, Ms^Vhha, Ms^Xm, Ha, Ha^Es, Ai^Qhu, Gd^Qhu, Gd^Qhu, Aa^Fpa, Rd, Rd, Aa^Fda, Qxu, Aa^Esa, Qxu, Qxu, Qxu, Ha, Gd, Gd^Qhh, Aa^Qhhf, Aa^Qhh, Gd, Aa^Qhh, Aa^Qhh, Ha, Ms, Ms^Xm
Ai^Qhu, Aa, Aa, Aa^Es, Ai^Qhu, Ai^Qhu, Aa, Aa^Qhu, Gd^_ml, Gd^Qhu, Rd, Ha^Fpa, Ms, Ms^Xm, Ms^Xm, Aa^Esa, Ms^Xm, Ms, Aa^Qhh, Gd^Qhh, Gd, Aa, Ms, Aa^Qhh, Ha, Aa, Ms, Ms^Xm, Ms^Xm
Ai^Qhu, Ai^Qhu, Ai^Qhu, Ai^Qhu, Ai^Qhu, Ai^Qhu, Aa, Aa^Qhu, Aa^Qhu, Aa^Qhu, Rd, Ha^Es, Ha^Fda, Ms, Ms^Xm, Ms^Xm, Ms, Ha, Rd^Qhh, Aa^Fma, Ha^Fma, Aa^Vla, Ms^Xm, Ms, Uue, Ms, Ms, Ms^Xm, Ms^Xm
Ai^Qhu, Aa, Aa, Ai^Qhu, Aa, Aa, Gd, Aa, Aa^Qhu, Aa^Qhu, Aa^Qhu, Rd, Gd^Esa, Ms, Ms, Ms^Xm, Ha, Ha, Rd^Qhh, Ha^Fda, Ms, Ms, Ms^Xm, Xue, Uhe, Uue, Xue, Ms^Xm, Ms^Xm
Ha, Ha, Aa^Fpa, Aa, Aa^Fpa, Gd^Esa, Gd^Esa, Aa, Aa^Qhu, Gd^Qhu, Gd^Qhu, Rd, Gd, Gd^Esa, Aa^Fma, Aa^Es, Aa^Qhh, Rd^Qhh, Ms, Ha, Ms^Xm, Ms^Xm, Xue, Xue, Uue, Re, Xue, Ms^Xm, Ms^Xm
Ms^Xm, Ms, Ha^Fpa, Ha^Fpa, Ha^Qhh, Gd^Esa, Aa^Qhh, Aa, Aa, Aa^Qhu, Gd^Qhu, Gd^Qhu, Rd, Gd^Es, Aa^Qhhf, Aa^Qhhf, Ha^Fpa, Ms, Ms, Ms, Xue, Xue, Uue^Tf, Re, Uue^Tf, Re^Tf, Xue, Ms^Xm, Ms^Xm
Ms^Xm, Ms, Ha, Ha^Qhh, Cva, Ha^Qhh, Cva, Aa^Qhh, Aa^Qhh, Aa, Aa, Aa^Qhu, Rd, Aa, Gd^Qhh, Aa^Fda, Ha^Fpa, Aa^Vea, Ms^Xm, Ms^Xm, Xue, Uhe, Uue, Uhe, Uhe, Xue, Qxu, Ms^Xm, Ms^Xm
Ms^Xm, Ms^Xm, Ha, Aa^Qhh, Rra^Vea, Rra, Ha^Fpa, Ha, Aa^Qhh, Aa, Gd, Gd^Qhu, Rd, Aa, Gd^Qhh, Gd^Esa, Ms, Ms, Ms, Ms^Xm, Xue, Xue, Re, Re, Uue^Tf, Xue, Qxu, Ms^Xm, Ms^Xm
Ms^Xm, Ms^Xm, Ha, Ha^Qhh, 4 Kva, Cva^Feta, Rra^_mhh, Cva, Aa^Qhh, Aa, Gd^Qhu, Gd^Qhu, Rd, Aa, Aa, Aa^Qhh, Aa^Fma, Ms, Ha^Esa, Xue, Uue, Uue^Tf, Re, Uue, Xue, Xue, Qxu, Ms^Xm, Ms^Xm
Ms^Xm, Ms^Xm, Ms^Xm, Ha^Qhh, Ha^Qhh, Rra^Vea, Cva, Aa^Qhh, Ha, Aa, Aa^Qhu, Aa^Qhu, Gd, Gd^Esa, Aa^Es, Aa^Qhhf, Aa^Fda, Ha, Aa^Fpa, Ha^Fda, Uhe, Uhe, Re, Uhe, Xue, Qxu^_mh, Ms^Xm, Ms^Xm, Ms^Xm
Ms^Xm, Ms^Xm, Ms^_mh, Ms^Xm, Ms^Xm, Ha^Qhh, Ha^Qhh, Ha^Qhh, Aa, Aa^Qhu, Aa^Fpa, Aa^Fpa, Aa^Fda, Rd^Esa, Aa^Esa, Aa^Qhhf, Gd, Aa, Ha^Fda, Aa, Ms, Xue, Xue, Xue, Qxu, Qxu, Ms^Xm, Ms^Xm, Ms^Xm
Ms^Xm, Ms^Xm, Ms^Xm, Ms^Xm, Ms^Xm, Ms, Ms, Ms, Aa^Qhu, Aa^Qhu, Gd, Aa^Fda, Aa^Fma, Aa^Fpa, Rd, Gd^Qhh, Gd^Qhh, Ha^Fma, Ha, Ms, Ms^Xm, Ms^Xm, Ms^Xm, Qxu, Ms^Xm, Ms^Xm, Ms^Xm, Ms^Xm, Ms^Xm
Ms^Xm, Ms^Xm, Ms^Xm, Ms^Xm, Ms^Xm, Ms^Xm, Ms^Xm, Ha, Aa^Qhu, Aa, Gd, Gd^Es, Aa, Aa, Aa, Rd, Gd, Aa^Qhh, Aa, Aa, Ms^Xm, Ms^Xm, Ms^Xm, Ms^Xm, Ms^Xm, Ms^Xm, Ms^Xm, Ms^Xm, Ms^Xm
