Aa^Fda, Aa^Fda, Aa^Fda, Aa^Fda, Aa^Fma, Aa^Fma, Aa, Aa, Gd, Gd, Gd, Gd^Qhh, Gd^Qhh, Gd^Qhh, Rp^Qhh, Aa, Aa, Aa^Qhhf, Aa^Qhhf, Aa^Qhhf, Aa^Qhhf, Aa^Qhhf, Aa, Aa, Aa^Qhhf, Aa^Qhhf, Aa^Qhhf, Aa^Qhhf
Aa^Fda, Aa^Fda, Cva, Aa^Fma, Re, Aa^Fma, Aa, Aa, Gd, Gd, Gd, Gd, Gd^Qhh, Gd, Rp, Aa, Aa^Esa, Aa^Fma, Aa^Fma, Aa^Fda, Aa, Aa, Gd, Gd, Aa, Aa^Fda, Aa^Fda, Aa^Qhhf
Aa^Fma, Aa^Fda, Cva^Vka, Cva, Aa^Fma, Re, Aa, Gd, Gd, Gd, Gd, Gd, Gd, Rp^Qhh, Gd^Qhh, Gd, Aa^Esa, Aa^Fma, Aa^Fma, Aa, Gd, Aa^Esa, Aa^Esa, Aa^Esa, Gd, Gd, Aa^Esa, Aa^Qhhf
Gd, Cva, 4 Kva, Cva, Aa^Fma, Aa^Fma, Aa^Esa, Gd, Gd^Qhu, Gd^Efm, Gd^Qhu, Gd^Qhu, Gd^Qhu, Rp, Gd^Qhh, Aa, Gd^Efm, Aa, Aa, Aa^_mh, Aa, Gd, Ce, Aa, Ce, Aa^Esa, Aa^Qhh, Aa^Qhh
Aa^Fma, Gd, Re, Aa^Fma, Aa^Fma, Aa^Esa, Re^Qhu, Gd^Qhu, Gd^Qhu, Gd^Qhu, Ww, Ww, Gd^Qhu, Rp^Qhu, Rp, Aa^Qhh, Aa^Qhh, Gd, Aa, Gd, Gd^Qhh, Aa^Qhh, Ce^Qhh, Ce, Ce, Gd^Qhh, Aa^Fda, Aa^Fda
Gd, Aa^Fma, Re, Aa^Fma, Gd^Qhu, Gd^Qhu, Wwf, Ww, Ww, Ww, Wo, Ww, Ww, Gd^Qhu, Rp, Gd^Qhh, Gd^Qhh, Aa^Qhh, Gd^Qhh, Gd^Qhh, Gd, Gd, Ce, 1 Ke^Qhh, Ce^Qhh, Gd^Qhh, Aa^Fda, Aa^Fda
Gd^Qhu, Re, Gd, Gd, Gd^Qhu, Ww, Aa, Aa^Vha, Ww, Ww, Ww, Wo, Ww, Gd^Qhu, Rp, Gd, Gd, Gd, Gd^Efm, Gd, Gd, Gd, Gd, Ce, Gd, Gd, Gd, Aa^Fda
Re, Re^Qhu, Gd^Qhu, Gd^Qhu, Gd, Ww, Ww, Ww, Aa^Esa, Aa^Esa, Ww, Ww, Ww, Rp^Qhu, Aa^Qhu, Gd, Aa^Qhu, Aa, Aa^Qhu, Gd, Gd^Qhu, Gd^Qhu, Gd^Qhu, Gd^Qhu, Aa^Qhu, Gd, Gd, Gd
Aa^Fma, Gd, Gd, Gd^Qhu, Gd, Ww, Wo, Ww, Ww, Ww, Wo, Ww, Aa, Ww^Bw|, Ww, Aa^Qhu, Wwf, Aa^Qhu, Ww, Gd^Qhu, Aa, Gd, Aa, Aa^Qhu, Aa, Aa^Qhu, Aa^Fda, Aa^Fda
Aa^Fma, Aa^Fma, Aa^Fma, Gd^Qhu, Gd^Qhu, Ww, Ww, Ww, Aa, Gd, Ww, Ww, Aa^Esa, Rp, Aa^Esa, Ww, Aa, Ww, Aa^Esa, Wwf, Ww, Aa, Ww, Aa^Vha, Aa, Aa^Qhu, Aa^Fda, Aa^Fda
Ms, Ms, Ms, Ha, Ai, Wwf^Qhu, Gd^Qhu, Gd, Aa^Esa, Aa^Esa, Gd, Aa^Esa, Gd, Rp, Rp, Aa^Esa, Gd^_ml, Aa, Aa, Aa^Esa, Gd, Wwf, Aa, Ww, Wwf, Aa^Qhu, Aa^Qhu, Aa^Fda
Re, Ms^Xm, Ms, Ms, Ai, Hhd, Ha, Aa^Qhu, Aa^Qhu, Aa^Qhu, Aa^Qhu, Gd, Aa^Qhu, Aa, Rp^Qhu, Gd, Gd^Qhu, Aa, Aa, Gd, Gd, Aa, Aa, Aa, Gd, Ww, Ww, Aa^Qhu
Ha, Re, Ai, Ai, Ha, Ms, Ms, Ha, Hhd, Aa^Fpa, Ha, Gd^Qhu, Gd, Rp^Qhu, Aa^Qhu, Aa, Aa^Qhu, Gd^Qhu, Aa^Qhu, Aa, Aa^Qhu, Gd, Aa^Qhu, Gd, Aa, Aa, Aa, Re
Aa, Aa, Ai, Re, Re, Ms^Xm, Ms^Xm, Ms, Ha^Fma, Hhd, Hhd, Aa, Aa, Rp, Gd, Aa^Qhu, Gd, Gd, Gd, Aa^Qhu, Aa, Gd^Qhu, Aa, Aa^Qhu, Aa^Qhu, Aa^Qhu, Gd^Qhu, Gd^Qhu
Ai, Wwf, Gd, Ha, Ha, Ms, Ms, Ms, Ms, Ha^Esa, Ha^Fma, Aa^Fpa, Aa, Rp, Aa, Aa, Aa, Gd^Esa, Aa^Esa, Aa, Aa, Aa^Vha, Aa, Aa^Fma, Aa^Fda, Aa^Fda, Aa, Aa^Fma
Aa, Gd, Aa, Hhd, Aa^Fma, Aa^Fma, Ms, Ha, Ha, Ha^Esa, Ms^Xm, Aa^Fpa, Aa^Fpa, Rp^Esa, Rp^Esa, Aa^Esa, Aa^Esa, Aa, Gd^Efm, Gd, Gd, Aa, Aa^Fma, Aa^Fma, Aa, Aa^Fda, Aa^Fda, Aa^Fma
Aa, Aa^Vha, Cva, Aa^Fma, Gd, Aa^Fma, Ms, Ms, Ms^Xm, Ms, Ms, Ms, Ha, Aa^Esa, Rp, Aa^Esa, Aa, Aa, Aa^Esa, Aa, Aa, Ha^Fma, Aa^Fma, Cva, 5 Kva, Cva, Aa^Fda, Aa
Aa, Cva, Aa^Fma, Aa^Fma, Cva^Qhu, Gd, Ha^Qhu, Ms, Ms, Ms, Ms^Xm, Ms, Ha, Aa, Rp, Aa, Gd^Efm, Gd^Esa, Aa, Gd, Gd, Ha, Ha^Fma, Cva, Cva, Cva, Aa^Fda, Ww
Aa, Cva, 3 Kva, Cva^Qhu, Gd, Gd^Qhu, Aa^Vha, Ha^Qhu, Ha, Ms, Ms, Ms, Ms, Ha^Fma, Hhd, Rp, Gd, Aa, Aa^Qhh, Aa^Qhh, Aa^Qhh, Ha, Aa^Qhh, Ha, Ha, Aa^Fda, Aa^Qhh, Aa^Qhh
Aa, Cva, Cva, Cva^Qhu, Gd^Esa, Aa^Esa, Aa, Ha^Qhu, Aa^Qhu, Ms, Ms, Ms, Ms^Xm, Ms, Ha, Rp, Rp^Qhh, Ha^Qhh, Gd, Aa, Gd, Gd^Qhh, Aa, Aa^Qhh, Aa^Qhh, Aa^Qhh, Gd^Esa, Ha
Re, Aa^Es, Aa, Gd^Qhu, Gd^Esa, Gd^_ml, Gd^Es, Gd^Es, Aa^Qhu, Ha, Ha^Esa, Ms, Ms, Ms, Ha, Hhd, Rp^Qhh, Gd, Aa, Aa, Gd^Efm, Aa, Gd^Efm, Gd, Aa, Gd^Esa, Aa, Ha
Gd^Es, Re, Re, Re^Qhu, Gd^Qhu, Re^Esa, Re^Qhu, Ha^Es, Re^Qhu, Aa, Aa^Esa, Aa^Esa, Hhd, Hhd, Rp^Qhh, Rp^Qhh, Gd, Aa, Aa, Aa, Gd^Esa, Gd, Gd^Qhu, Gd^Qhu, Hhd^Qhu, Aa, Aa, Aa
Aa^Fda, Gd^Es, Gd, Gd, Gd, Gd^Qhu, Aa, Gd^Qhu, Ha, Re^Esa, Ha^Esa, Re^Esa, Rp, Rp^Qhh, Hhd, Ha, Aa, Gd, Gd^_mh, Gd^Esa, Gd, Hhd^Qhu, Ha^_ml, Ha^Esa, Aa^Qhu, Gd, Aa^Fda, Aa^Fda
Aa^Qhhf, Aa^Qhhf, Aa^Qhhf, Aa^Qhh, Gd^Qhh, Gd^Qhh, Gd^Qhh, Aa, Aa, Hhd, Hhd, Ha^Esa, Rp, Gd^Qhh, Ha, Aa, Aa, Gd, Aa^Fma, Aa, Aa, Aa^Qhu, Aa^Qhu, Aa^Qhu, Gd^Qhu, Gd^Qhu, Hhd, Aa^Fda
Gd^Qhh, Aa^Fda, Aa, Aa, Gd^Esa, Gd^Esa, Aa, Aa^Qhh, Aa^Qhh, Aa^Qhh, Rp^Qhh, Rp, Hhd, Ha^Qhh, Gd^Qhh, Aa, Gd^Esa, Aa, Aa, Aa^Fma, Gd^Esa, Aa^Fma, Aa, Aa^Fma, Ha, Ha, Hhd, Hhd
Gd^Qhh, Aa^Fda, Gd, Aa, Aa, Gd^Esa, Aa, Ha, Ha, Hhd, Rp, Ha^Qhh, Ha, Hhd^Vhha, Aa, Gd^Qhh, Aa, Aa^Fma, Aa, Gd^Esa, Ha, Ha, Aa^Qhhf, Aa^Vha, Ha^Qhhf, Hhd^Qhh, Ha^Qhh, Ha^Qhh
Aa^Qhhf, Gd, Aa^Fda, Aa, Aa, Aa, Gd^_mh, Aa, Aa, Aa, Aa^Esa, Rp^Qhh, Rp, Aa, Aa, Gd^Qhh, Gd^Qhh, Aa^Qhh, Aa^Qhh, Aa^Fma, Hhd^Qhh, Ha^Qhhf, Ha^Fma, Aa^Qhhf, Ms, Aa, Ms^Xm, Ha
Aa^Qhhf, Aa^Fda, Aa^Fda, Aa^Fda, Re, Gd^Esa, Gd^Esa, Gd, Gd^Efm, Gd^Efm, Aa^Esa, Aa^Qhh, Rp, Gd, Gd, Aa, Gd, Aa, Aa, Hhd^Qhh, Ha, Ha^Fma, Ms, Ms, Ms, Ms, Ms^Xm, Ms^Xm
Aa^Qhhf, Re, Aa^Fda, Aa^Esa, Aa^Fda, Gd^Esa, Aa^Fda, Gd, Aa, Aa, Aa^Qhh, Aa^Qhh, Rp, Aa, Cva, Aa, Gd, Aa^Fma, Hhd, Aa, Ha^Fma, Ms, Ms, Ms, Ms^Xm, Ms, Ms^Xm, Ms^Xm
Aa^Qhhf, Re, Aa^Qhhf, Aa^Vha, Aa^Esa, Gd, Aa^Fda, Aa, Aa^Qhh, Aa^Qhh, Aa, Rp, Gd, Cva, 2 Kva, Cva, Ha, Aa^Fma, Ha^Fma, Aa, Ms, Ha, Ms, Ms^Xm, Ms^Xm, Ms^Xm, Ms^Xm, Ms^Xm
Aa^Qhhf, Aa^Qhhf, Gd^Efm, Aa^Qhhf, Aa^Qhhf, Aa^Qhhf, Aa^Qhhf, Aa^Qhhf, Aa, Aa, Aa, Rp, Gd^Efm, Cva, Cva, Cva, Aa, Ha, Ha^Fma, Ha^Fma, Ha^Fma, Ms, Ms, Ms^Xm, Ms^Xm, Ms^Xm, Ms^Xm, Ms^Xm
Aa^Fda, Aa^Fda, Gd, Aa^Fda, Aa^Fda, Aa^Fda, Aa^Fda, Aa^Fda, Aa^Fda, Gd, Gd, Rp, Gd, Aa^Fma, Aa^Fma, Aa^Fma, Aa^Fma, Aa, Aa, Ha, Ms^Xm, Ms, Ms^Xm, Ms^Xm, Ms^Xm, Ms^Xm, Ms^Xm, Ms^Xm
Gg, Aa^Fda, Aa, Aa^Fda, Ha, Aa^Fda, Aa^Fda, Aa^Fda, Aa^Fda, Gd, Gd, Rp, Rp, Aa^Fma, Aa^Fma, Aa^Fma, Aa, Aa, Aa, Ha, Gg, Ms^Xm, Ms^Xm, Ms^Xm, Ms^Xm, Ms^Xm, Ms^Xm, Ms^Xm
