Gs^Fds, Gs^Fds, Gs^Fds, Gs^Fds, Gs^Fms, Gs^Fms, Gg, Gg, Gg, Gg, Gg, Gg, Gg, Gg, Rp, Gg, Gg, Gs^Fms, Gs^Fds, Gs^Fds, Gs^Fds, Gs^Fds, Gg, Gg, Gg, Gg, Gg, Gs^Fds
Gs^Fds, Gs^Fds, Gs^Fms, Gs^Fms, Re, Gs^Fms, Gg, Gg, Gg, Gg, Gg, Gg, Gg, Gg, Rp, Gg, Gg, Gs^Fms, Gs^Fms, Gs^Fds, Gg, Gg, Gg, Gg, Gg, Gg, Gg, Gs^Fds
Gs^Fms, Gs^Fds, Gg^Vh, Re, Gs^Fms, Re, Gg, Gg, Gg, Gg, Gg, Gg, 3 Gg, Rp, Gg, Gg, Gg, Gs^Fms, Gs^Fms, Gg, Gg, Gg, Gg, Gg, Gg, Gg, Gg, Gs^Fds
Gg, Gs^Fms, Gs^Fms, Re, Gs^Fms, Gs^Fms, Re, Gg, Gg^Efm, Gg^Efm, Gg, Gg, Gg, Rp, Gg, Gg, Gg^Efm, Gg, Gg, Gg, Gg, Gg, Ce, Gg, Ce, Gg, Gg, Gg
Gs^Fms, Gg, Re, Gs^Fms, Gs^Fms, Gg, Re, Gg, Gg, Gg, Ww, Ww, Gg, Rp, Rp, Gg, Gg, Gg, Gg, Gg, Gg, Gg, Ce, Ce, Ce, Gg, Gg, Gs^Fds
Gg, Gs^Fms, Re, Gs^Fms, Gg, Gg, Wwf, Ww, Ww, Ww, Wo, Ww, Ww, Gg, Rp, Gg, Gg, Gg, Gg, Gg, Gg, Gg, Ce, Ke, Ce, Gg, Gg, Gs^Fds
Gg, Re, Gg, Gg, Gg, Ww, Gg, Gg^Vh, Ww, Ww, Ww, Wo, Ww, Gg, Rp, Gg, Gg, Gg, Gg^Efm, Gg, Gg, Gg, Gg, Ce, Gg, Gg, Gg, Gs^Fds
Re, Re, Gg, Gg, Gg, Ww, Ww, Ww, Gg, Gg, Ww, Ww, Ww, Rp, Gg, Gg, Gg, Gg, Gg, Gg, Gg, Gg, Gg, Gg, Gg, Gg, Gg, Gg
Gs^Fms, Gg, Gg, Gg, Gg, Ww, Wo, Ww, Ww, Ww, Wo, Ww, Gg, Ww^Bw|, Ww, Gg, Wwf, Gg, Ww, Gg, Gg, Gg, Gg, Gg, Gg, Gg, Gg, Gs^Fds
Gs^Fms, Gs^Fms, Gs^Fms, Gg, Gg, Ww, Ww, Ww, Gg, Gg, Ww, Ww, Gg, Rp, Gg, Ww, Gg, Ww, Gg, Wwf, Ww, Gg, Ww, Gg^Vh, Gg, Gg, Gg, Gs^Fds
Gg, Hh^Vhh, Hh, Hh, Ww, Wwf, Gg, Gg, Gg, Gg, Gg, Gg, Gg, Rp, Rp, Gg, Gg, Gg, Gg, Gg, Gg, Wwf, Gg, Ww, Wwf, Gg, Gg, Gg
Re, Mm, Mm, Hh, Ww, Hh, Hh, Gg, Gg, Gg, Gg, Gg, Gg, Gg, Rp, Gg, Gg, Gg, Re^Gvs, Re^Gvs, Re^Gvs, Gg, Gg, Gg, Gg, Ww, Ww, Gg
Hh, Re, Wwf, Ww, Mm, Hh, Hh, Hh, Hh, Gs^Fp, Hh, Gg, Gg, Rp, Gg, Gg, Re^Gvs, Re^Gvs, Re^Gvs, Re^Gvs, Re^Gvs, Re^Gvs, Gg, Gg, Gg, Gg, Gg, Re
Gg, Gg, Ww, Re, Re, Mm, Mm, Hh^Vhh, Hh^Fp, Hh, Hh, Gg, Gg, Rp, Gg, Re^Gvs, Re^Gvs, Re^Gvs, Re^Gvs, Re^Gvs, Gg, Gg, Gg, Gg, 2 Gg, Gg, Gg, Gg
Ww, Wwf, Gg, Hh, Hh, Hh, Mm, Mm, Mm, Hh, Hh^Fp, Gs^Fp, Gg, Rp, Gg, Gg, Gg, Re^Gvs, Gg, Gg, Gg, Gg^Vh, Gg, Gs^Fms, Gs^Fds, Gs^Fds, Gg, Gs^Fms
Gg, Gg, Gg, Hh, Gs^Fmw, Hh^Fmw, Hh, Mm^Vhh, Hh, Hh, Hh, Gs^Fp, Gs^Fp, Rp, Rp, Gg, Gg, Gg, Gg^Efm, Gg, Gg, Gg, Gs^Fms, Gs^Fms, Gg, Gs^Fds, Gs^Fds, Gs^Fms
Gg, Gg^Vh, Ce, Gs^Fmw, Gg, Gs^Fmw, Hh, Mm, Mm, Mm, Mm, Hh, Hh, Gg, Rp, Gg, Gg, Gg, Gg, Gg, Gg, Hh^Fms, Gs^Fms, Gs^Fms, Gs^Fds, Gs^Fds, Gs^Fds, Gg
Gg, Ce, Gs^Fmw, Gs^Fmw, Ce, Gg, Gg, Hh, Hh, Mm, Mm, Hh^Fp, Hh, Gg, Rp, Gg, Gg^Efm, Gg, Gg, Gg, Gg, Hh, Hh^Fms, Gs^Fms, Gs^Fds, Gs^Fds, Gs^Fds, Ww
Gg, Ce, Ke, Ce, Gg, Gg, Gg^Vh, Gg, Hh, Hh, Mm, Hh, Hh, Hh^Fp, Hh, Rp, Gg, Gg, Gg, Gg, Gg, Hh, Gg, Hh, Hh, Gs^Fds, Gg, Gg
Gg, Ce, Ce, Ce, Gg, Gg, Gg, Gg, Gg, Hh, Mm, Hh, Mm, Hh^Fp, Hh, Rp, Rp, Hh, Gg, Gg, Gg, Gg, Gg, Gg, Gg^Efm, Gg, Gg, Hh
Re, Gg, Gg, Gg, Gg, Gg, Gg, Gg, Gg, Hh, Hh, Hh, Hh, Mm, Hh, Hh, Rp, Gg, Gg, Gg, Gg^Efm, Gg, Gg^Efm, Gg, Gg, Gg, Gg, Hh
Gg, Re, Re, Re, Gg, Re, Re, Hh, Re, Gg, Gg, Gg, Hh, Hh, Rp, Rp, Gg, Gg, Gg, Gg, Gg, Gg, Gg, Gg, Hh, Gg, Gg, Re
Gs^Fds, Gg, Gg, Gg, Gg, Gg, Gg, Gg, Hh, Re, Hh, Re, Rp, Rp, Hh, Hh, Gg, Gg, Gg, Gg, Gg, Hh, Hh, Hh, Gg, Gg, Gg, Gs^Fms
Gs^Fds, Gs^Fds, Gs^Fds, Gg, Gg, Gg, Gg, Gg, Gg, Hh, Hh, Hh, Rp, Gg, Hh, Gg, Gg, Gg, Gs^Fms, Gg, Gg, Gg, Gg, Gg, Gg, Gg, Hh, Gs^Fms
Gg, Gs^Fds, Gg, Gg, Gg, Gg, Gg, Gg, Gg, Gg, Rp, Rp, Hh, Hh, Gg, Gg, Gg, Gg, Gg, Gs^Fms, Gg, Gs^Fms, Gg, Gs^Fms, Hh, Hh, Hh, Re
Gg, Gs^Fds, Gg, Gg, Gg, Gg, Gg, Hh, Hh, Hh, Rp, Hh, Hh, Hh^Vhh, Gg, Gg, Gg, Gs^Fms, Gg, Gg, Hh, Hh, Gs^Fms, Gg^Vh, Hh, Hh, Hh, Gg
Gs^Fds, Gg, Gs^Fds, Gg, Gg, Gg, Gg, Gg, Gg, Gg, Gg, Rp, Rp, Gg, Gg, Gg, Gg, Gg, Gg, Gs^Fms, Hh, Hh^Fms, Hh^Fms, Gs^Fms, Mm, Gg, Mm^Xm, Gg
Gs^Fds, Gs^Fds, Gs^Fds, 1 Gs^Fds, Re, Gg, Gg, Gg, Gg^Efm, Gg^Efm, Gg, Gg, Rp, Gg, Gg, Gg, Gg, Gg, Gg, Hh, Hh, Hh^Fms, Mm, Mm, Mm, Mm, Mm^Xm, Gs^Fms
Gs^Fds, Re, Gs^Fds, Gg, Gs^Fds, Gg, Gs^Fds, Gg, Gg, Gg, Gg, Gg, Rp, Gg, Ch, Gg, Gg, Gs^Fms, Hh, Gg, Hh^Fms, Mm^Vhh, Mm, Mm, Mm^Xm, Mm, Mm^Xm, Gs^Fms
Gs^Fds, Re, Gs^Fds, Gg^Vh, Gg, Gg, Gs^Fds, Gg, Gg, Gg, Gg, Rp, Gg, Gg^Vh, Kh, Gg^Vh, Hh, Gs^Fms, Hh^Fms, Gg, Mm, Hh, Mm, Mm^Xm, Mm^Xm, Mm^Xm, Mm^Xm, Gs^Fms
Gg^Efm, Gs^Fds, Gg^Efm, Gs^Fds, Gs^Fds, Gs^Fds, Gs^Fds, Gs^Fds, Gg, Gg, Gg, Rp, Gg^Efm, Ch, Gg, Ch, Gg, Hh, Hh^Fms, Hh^Fms, Hh^Fms, Mm, Mm, Mm^Xm, Mm^Xm, Mm^Xm, Mm^Xm, Gs^Fds
Gs^Fds, Gs^Fds, Gg, Gs^Fds, Gs^Fds, Gs^Fds, Gs^Fds, Gs^Fds, Gs^Fds, Gg, Gg, Rp, Gg, Gs^Fms, Gs^Fms, Gs^Fms, Gs^Fms, Gg, Gg, Hh, Mm^Xm, Mm, Mm^Xm, Mm^Xm, Mm^Xm, Mm^Xm, Mm^Xm, Gs^Fds
Gg, Gs^Fds, Gg, Gs^Fds, Gg, Gs^Fds, Gs^Fds, Gs^Fds, Gs^Fds, Gg, Gg, Rp, Rp, Gs^Fms, Gg, Gs^Fms, Gg, Gg, Gg, Hh, Gg, Mm^Xm, Gs^Fds, Mm^Xm, Gs^Fds, Mm^Xm, Gs^Fds, Gs^Fds
