Gd^Qhu, Gd^Qhu, Aa^Qhu, Aa^Fpa, Aa^Qhuf, Re, Re^Qhu, Aa^Fpa, Aa^Qhuf, Aa^Qhuf, Ww^Qhu, Ww^Qhu, Ha, Ms, Ms, Ms, Ms, Gd, Ms^Xm, Ms^Xm, Ms^Xm, Ms^Xm, Ms^Xm, Ms^Xm
Gd^Qhu, Gd^Qhu, Gd, Gd^Qhu, Gd, Aa^Qhuf, Aa^Fda, Re^Qhu, Re, Aa^Fpa, Aa^Fpa, Ww^Qhu, Ww^Qhu, Ai, Ai, Ha, Ha, Ms, Ms, Ms, Ms, Ms^Xm, Ms^Xm, Ms^Xm
Aa^Qhuf, Aa^Fpa, Aa^Fda, Aa^Fpa, Gd^_mll, Aa^Fpa, Aa^Fda, Gd, Aa, Re, Cea, Aa^Fda, Aa^Fda, Re^Qhu, Aa^Qhuf, Aa, Ai, Ha, Ai, Ms, Ms, Ms, Ms, Ms
Aa^Qhuf, Aa^Fda, Aa^Fma, Aa^Fma, Aa^Fpa, Aa^Dr, Aa^Fma, Gd, Gd, Cea, 1 Kea, Cea, Aa^Fpa, Re, Re, Ww^Qhu, Aa^Vla, Ai, Ha^Qhu, Ai, Ai, Ms, Ha, Ms
Aa^Qhuf, Aa^Dr, Aa^Fpa, Aa^Fda, Aa^Feta, Aa^Fma, Gd, Aa, Gd, Cea, Cea, Cea, Aa^Fma, Aa^Fda, Re, Ww^Qhu, Wwg^Qhu, Aa^Qhu, Aa, Ha^Qhu, Ai^Qhu, Ha, Ha^Qhu, Ha
Gd^Qhu, Gd^Esa, Aa^Fda, Aa^Fda, Aa^Fda, Aa^Fda, Aa^Fpa, Gd, Gd, Re, Re, Gd, Gd^Esa, Aa^Fma, Aa^Fpa, Re, Aa^Esa, Ai, Aa, Ai^Esa, Ai^Esa, Ai^Qhu, Ai, Ai^Qhu
Aa^Qhu, Gd^Esa, Aa^Fpa, Gd, Gd^Es, Gd, Gd, Gd^Esa, Aa^Esa, Aa^Esa, Aa, Re, Gd, Gd^Esa, Gd, Re, Aa, Ai^Esa, Ai^Qhu, Aa, Ai, Ai, Ai, Ai^Qhu
Aa^Qhu, Aa, Gd, Gd^Esa, Gd^Esa, Gd^Es, Aa, Aa, Aa^Qhu, Aa^Qhu, Aa^Qhu, Re, Re, Aa, Aa, Re, Aa^Qhu, Aa^Qhu, Ha, Aa^Qhu, Ai^Qhu, Aa^Esa, Ai^Qhu, Ai^Qhu
Aa^Qhu, Aa^Qhu, Gd^Qhu, Gd^Qhu, Gd^Qhu, Gd, Aa^Qhu, Aa^Qhu, Ha^Es, Ha^Esa, Aa, Aa^Qhu, Re^Qhu, Aa, Aa^Qhu, Re^Qhu, Gd^Esa, Gd^Esa, Ha^Es, Aa^Vha, Aa, Ai^Qhu, Ha, Ha
Aa, Aa^Esa, Gd^Es, Aa^Fpa, Gd^Esa, Gd^Qhu, Gd, Aa, Aa^Es, Gd^Es, Hhd, Hhd, Re, Aa^Qhu, Gd, Re, Re, Ha^Es, Ha^Es, Aa^Esa, Ha, Aa, Ms^Xm, Ms
Gd, Gd^Esa, Aa^Fma, Aa^Fma, Gd, Gd, Aa^Fda, Gd^Esa, Gd^Esa, Aa^Fda, Aa^Fma, Aa^Fpa, Re, Aa, Gd, Aa^Fpa, Aa^Dr, Re, Aa^Fda, Aa, Aa^Esa, Ms, Ms, Ms^Xm
Aa^Fpa, Aa^Fpa, Aa^Fpa, Aa^Fda, Aa^Fpa, Aa^Fma, Ha, Aa^Fda, Aa^Fpa, Aa^Fma, Aa^Vha, Aa^Fpa, Re, Gd, Aa^Fda, Aa^Fda, Aa^Fpa, Re, Re, Gd, Aa, Ha, Ha, Aa^Fpa
Aa^Fpa, Aa^Fda, Ha^Fpa, Aa^Fda, Aa^Fma, Ha, Ms^Xm, Ms, Ms, Aa^Fda, Aa^Fda, Re, Gd, Aa^Fpa, Gd, Gd^Es, Gd^Esa, Aa^Fma, Re, Gd^Esa, Aa^Es, Gd, Gd, Aa^Fpa
Aa^Fpa, Ha^Fpa, Ha^Fda, Aa^Fma, Ha, Ms, Ms^Xm, Ms^Xm, Ha, Aa^Fpa, Gd^Esa, Re, Aa^Fpa, Aa^Fda, Aa^Fda, Gd^Esa, Gd, Gd, Aa, Re, Aa, Gd^Es, Gd, Aa^Fpa
Aa^Fpa, Aa^Fda, Aa^Fpa, Aa^Fpa, Aa^Fda, Ms, Ha, Ms, Aa^Fpa, Gd^Esa, Gd, Re, Gd, Gd, Aa^Fma, Aa^Fpa, Aa^Fda, Gd, Gd, Re, Aa^Dr, Aa, Aa^Es, Gd
Aa^Fpa, Gd^Es, Gd^Es, Aa^Fda, Aa^Fma, Aa^Fma, Aa^Fda, Aa^Fda, Gd, Aa, Re, Re, Aa^Fda, Aa^Fpa, Ha^Fpa, Ha, Aa^Fpa, Aa^Fda, Aa^Fpa, Re, Aa, Aa, Aa^Es, Aa
Aa^Fpa, Aa^Fpa, Aa^Fpa, Gd^Esa, Aa^Fpa, Aa^Fpa, Aa^Fpa, Gd, Re, Re, Aa, Gd, Ha^Fpa, Aa^Fda, Ms, Ha, Ms, Aa^Fma, Aa^Fda, Re, Gd^Esa, Aa^Esa, Aa, Aa
Aa^Fpa, Aa^Fpa, Aa^Fpa, Gd, Re, Re, Re, Re, Aa, Aa^Es, Aa^Es, Aa, Ha^Fpa, Ha, Ms^Xm, Ms^Xm, Ha, Ha^Fda, Gd, Re, Aa, Aa^Esa, Aa, Aa
Aa^Fpa, Gd, Re^Esa, Re, Gd, Gd^Esa, Gd^Dr, Aa, Aa^Esa, Aa^Esa, Aa, Aa^Esa, Aa^Fda, Ms, Ms, Ms^Xm, Ms, Ha^Fpa, Aa, Re, Aa, Ha, Ha, Ms
Aa^Fpa, Re, Gd, Gd^Esa, Gd, Re, Gd, Gd, Gd, Aa, Aa, Gd, Aa^Fda, Ha, Ha, Ms, Aa^Fda, Gd, Re, Re, Aa, Ha, Ms^Xm, Ms^Xm
Re, Re, Gd, Aa^Fpa, Gd, Re, Gd, Gd, Gd, Aa^Fpa, Gd, Aa^Fpa, Aa^Fma, Ha^Fpa, Aa^Dr, Aa^Fpa, Gd^Esa, Aa^Esa, Re, Aa^Vha, Aa, Ms, Ms^Xm, Ms^Xm
Re, Aa^Fpa, Aa^Fpa, Aa^Fma, Aa^Fma, Gd, Gd, Aa^Fpa, Aa^Fda, Aa^Fda, Aa^Fpa, Ha, Ms, Ha, Ww^Dr, Ww^Dr, Gd, Re, Aa, Aa, Ha, Ms, Ms^Xm, Ms^Xm
Aa^Fpa, Aa^Fpa, Aa^Fda, Aa^Fpa, Aa^Fpa, Re, Aa^Fpa, Aa^Fpa, Aa^Vha, Aa^Fpa, Aa^Fma, Ms, Ms^Xm, Ha, Ha, Ai, Aa^Esa, Re, Aa^Esa, Aa^Esa, Ha, Ha, Ms^Xm, Ms^Xm
Aa^Fpa, Aa^Fda, Aa^Fma, Aa^Fma, Aa^Fda, Re, Re, Aa^Fpa, Aa^Fpa, Aa^Fma, Gd^Es, Ha, Ha, Ai, Ai, Aa^Esa, Aa, Re, Aa, Aa, Aa^Esa, Ms, Ms, Ms^Xm
Aa^Fpa, Aa^Fpa, Aa^Fma, Aa^Fda, Aa^Fpa, Gd, Gd, Aa^Fpa, Aa^Fpa, Gd, Gd^Esa, Aa^Es, Aa^Esa, Ai^Esa, Ai, Ai^Esa, Ai, Re, Aa, Aa^Esa, Aa, Aa, Ha, Ms
Aa^Fpa, Aa^Dr, Aa^Fda, Gd, Gd^Esa, Aa, Aa, Re, Re, Aa, Aa^Esa, Aa, Aa^Esa, Aa^Esa, Aa, Aa, Ai, Ww^Bw|, Ww, Gd^Es, Aa^Fpa, Aa^Fpa, Ha^Esa, Ha
Aa^Fpa, Aa^Fda, Gd, Aa, Aa, Aa, Aa^Esa, Gd, Gd, Gd^Esa, Gd, Aa, Aa, Aa, Aa, Aa, Re, Re, Ww, Ww, Ms, Ms, Hhd^Dr, Ha
Gll^Fp, Aa^Fpa, Aa, Aa, Aa^Es, Aa^Esa, Gd^Esa, Gd, Aa^Fda, Aa^Fpa, Aa^Fda, Re, Re, Gd, Gd^Vh, Re, Ww^Dr, Ww^Dr, Ww^Es, Ha^Es, Ms, Ms^Xm, Ms, Ha
Gll^Fp, Aa^Fda, Aa, Aa^Es, Aa, Aa, Gd, Aa^Fma, Gll^Fp, Gd, Gll^Fp, Ha, Aa^Fpa, Gd, Re, Re, Ai^Esa, Ai^Esa, Ww, Ha, Ms, Ms^Xm, Ms^Xm, Ms
Hhd, Gd, Ha, Aa, Aa, Gd^Esa, Aa^Fpa, Gll^Fp, Gd, Gd^Esa, Gd^Esa, Ha, Ai, Aa^Dr, Aa^Fpa, Ww^Bw|, Ww, Ww, Ha, Ww, Ww^Dr, Ms, Ha, Ai
Ha, Ai, Ai^Esa, Ai, Ai, Ha, Aa^Fda, Gd, Ww^Dr, Gd^Esa, Ww^Dr, Ai, Ai, Ai, Ms, Re, Ms, Ms, Ms, Ha, Ww^Dr, Ww^Dr, Ai, Ai
Ms, Ai^Esa, Ai, Ww, Ww, Ww, Gll^Fp, Gd^Esa, Hhd^Dr, Ww^Dr, Ww, Ha, Ms, Ms^Xm, Ms, Re^Esa, Ms, Ms^Xm, Ms^Xm, Ha, Ha, Ha, Ha, Aa
Ms, Ms, Ww, Ww, Ww, Ww, Ww^Es, Gd^Es, Gd^Dr, Ww, Ww, Ha, Ha, Ms, Ms, Re, Cfa^Esa, Ms, Ms^Xm, Ms^Xm, Ms, Ms, Ms^Xm, Ha
Ms^Xm, Ha^Vhha, Ha, Ww, Ha^Esa, Ww, Ww^Es, Gll^Fp, Gd^Esa, Ww, Ww, Ai^Esa, Ai^Esa, Ms, Ms^Xm, Cfa^Esa, Cfa, 2 Kfa, Cfa, Ha, Ms, Ms^Xm, Ms, Ms^Xm
Ms^Xm, Ms^Xm, Ms^Xm, Ms, Ms, Ha^Esa, Aa^Fda, Aa^Fma, Gll^Fp, Gll^Fp, Gll^Fp, Ww^Es, Ai, Ms, Ms, Ms, Cfa^Esa, Cfa^Esa, Hhd^Esa, Hhd, Ha, Ms, Aa, Aa
Ms, Ms^Xm, Ms^Xm, Ms, Ms, Ha, Gd^Esa, Aa^Fda, Gll^Fp, Gll^Fp, Gll^Fp, Ww, Ww, Ai, Hhd, Aa^Fpa, Re, Aa^Fpa, Aa^Vhca, Hhd^Esa, Gd^Es, Ha, Ha, Gd
Ms, Ms, Ms, Ms, Ha^Es, Ai, Aa, Aa^Fpa, Aa^Fpa, Aa^Fda, Aa^Fda, Ww, Aa^Fpa, Aa^Fpa, Aa^Fpa, Gll^Fp, Re, Gll^Fp, Aa^Fpa, Gd^Esa, Aa^Esa, Aa, Gd^Esa, Aa^Fpa
Aa^Fpa, Aa^Fda, Aa^Fda, Aa^Fma, Gd^Es, Aa^Es, Aa, Aa^Fda, Aa^Vha, Aa^Fpa, Ww, Ww, Gd^Esa, Aa^Fda, Gll^Fp, Gll^Fp, Re, Aa^Fda, Gd^Esa, Aa, Aa, Aa, Aa^Fda, Aa^Fpa
Aa^Fpa, Gd, Gd^Esa, Gd^Esa, Ww, Gd, Ww, Ww, Ww, Ww, Ww, Aa^Fpa, Aa^Dr, Aa^Fpa, Aa^Fda, Re, Gll^Fp, Aa^Fda, Gd, Gd^Esa, Gd, Gd, Ww, Ww
Aa^Fpa, Gd, Gd^Es, Ww, Ww, Ww, Ww, Ww, Ww, Ww, Aa^Fda, Aa^Fda, Aa^Fma, Aa^Fda, Aa^Fpa, Re, Aa^Fpa, Gd^Esa, Aa^Es, Gd, Ww, Ww, Ww, Ww
Gll^Fp, Aa^Fda, Ha, Ai, Gd^Es, Ww, Aa^Fpa, Aa^Fma, Gll^Fp, Aa^Fma, Aa^Fpa, Gd, Gd^Esa, Gd, Gd, Re, Gd, Gd^Esa, Aa, Aa, Ww, Ww, Ww, Ww
Ms^Xm, Ms, Ms, Ai, Gd, Gd, Aa^Fpa, Aa^Fma, Aa^Fpa, Aa^Fda, Aa^Fda, Gd^Esa, Aa, Aa, Re, Re, Aa, Aa, Aa^Esa, Gd^Esa, Aa^Fda, Gll^Fp, Ai, Ww
Ms^Xm, Ms^Xm, Ms^Xm, Ha^Es, Aa, Aa, Gd^Esa, Gd^Es, Gd^Esa, Gd^Es, Aa^Fpa, Gd, Aa^Esa, Aa^Esa, Re, Aa, Aa^Es, Aa^Dr, Gd, Gd^Es, Aa, Gll^Fp, Ha, Ai
Ms^Xm, Ms^Xm, Ms, Ha, Aa^Es, Aa^Es, Aa^Esa, Aa^Esa, Aa, Gd, Gd, Gd, Aa, Aa, Re, Aa^Es, Aa, Aa, Gd^Esa, Aa^Fpa, Ai, Ha, Ms, Ms
Ms^Xm, Ms^Xm, Ha^Es, Aa, Aa, Aa, Aa, Aa, Gd, Ha, Ha^Es, Ha^Es, Ha^Esa, Aa, Re, Aa^Esa, Aa, Ww, Ww, Ww, Ww, Ww, Ms, Ms
Ha, Ha, Gd^Esa, Gd, Aa^Esa, Aa^Esa, Aa^Esa, Ha^Esa, Hhd^Es, Hhd^Esa, Hhd, Hhd^Esa, Hhd^Es, Gd, Re^Esa, Aa, Gd^Esa, Aa^Fda, Aa^Fda, Aa^Fpa, Aa^Feta, Ha, Ms^Xm, Ms
Aa, Gd^Esa, Aa^Fpa, Aa^Fpa, Gd, Aa, Aa^Es, Ai, Ww, Ms, Ms, Ms, Hhd^Esa, Gd^Dr, Re, Aa, Gd, Aa^Fpa, Ai, Aa^Fma, Ai, Ha, Ms, Ms^Xm
Aa, Gd^Es, Aa^Dr, Aa^Fpa, Aa^Fma, Gd^Es, Ai, Ww, Ww, Ms, Ms, Ms^Xm, Ms^Xm, Aa^Fpa, Re, Aa, Ww, Ai, Ww, Aa^Fma, Ww, Ha, Aa^Fpa, Ms
Aa, Gd^Esa, Aa^Fpa, Aa^Fma, Aa^Fpa, Gd, Ha, Ha^Esa, Ww, Ww, Ai, Ha, Gll^Fp, Aa^Fda, Re, Ai, Ww, Gd, Aa^Vca, Ww, Ww, Ww, Ww, Ha
Aa, Gd, Aa^Fma, Aa^Fpa, Gll^Fp, Aa^Fpa, Ms, Ms^Xm, Ms, Ww, Ww, Ai, Ww, Aa^Fpa, Ww^Bw|, Ww, Gd^Esa, Gd^Esa, Gd, Aa^Fpa, Ai, Ai, Gd^Esa, Gd
Gd, Aa^Fpa, Aa^Fpa, Aa^Fma, Aa^Fpa, Aa^Fpa, Ha, Ms, Gll^Fp, Ha, Ha^Es, Ww^Es, Ww, Ww, Re, Ai, Aa^Fda, Aa^Fpa, Aa^Fma, Gd, Aa, Aa^Es, Aa, Aa
Aa^Fpa, Gll^Fp, Gll^Fp, Gll^Fp, Aa^Fpa, Gd^Es, Aa^Vha, Aa^Fpa, Gll^Fp, Gll^Fp, Gd^Esa, Gd^Esa, Gd, Gll^Fp, Re, Aa^Fda, Gll^Fp, Gll^Fp, Gd, Aa, Aa, Aa, Aa^Esa, Aa
Gd, Gll^Fp, Gd^Esa, Gll^Fp, Aa^Fpa, Aa^Fma, Aa^Fma, Aa^Fda, Aa^Fda, Gll^Fp, Gd, Gd, Gll^Fp, Gll^Fp, Re, Gll^Fp, Gd, Aa^Fpa, Gd^Esa, Aa^Esa, Aa, Aa^Esa, Aa, Aa
Gll^Fp, Gd^Esa, Gll^Fp, Aa^Fma, Aa^Fpa, Gd^Esa, Aa^Fpa, Gd^Esa, Aa^Fpa, Gll^Fp, Gd^Esa, Gd, Gll^Fp, Gll^Fp, Re, Gd, Gll^Fp, Aa^Fma, Gd, Aa, Aa^Esa, Aa, Aa, Aa^Esa
Gll^Fp, Gll^Fp, Gll^Fp, Aa^Fpa, Gd, Gd, Gd, Gd, Gd, Aa^Fpa, Aa^Fpa, Aa^Fpa, Gll^Fp, Gll^Fp, Re, Gll^Fp, Aa^Fpa, Gd, Aa, Aa, Aa, Gd, Aa, Aa
