Aa^Fda, Aa^Fda, Aa^Fda, Aa^Fda, Aa^Fma, Aa^Fma, Aa, Aa, Gs, Gs, Gs, Gd^Qhh, Gd^Qhh, Gd^Qhh, Rp^Qhh, Aa, Aa, Aa^Qhhf, Aa^Qhhf, Aa^Qhhf, Aa^Qhhf, Aa^Qhhf, Aa, Aa, Aa^Qhhf, Aa^Qhhf, Aa^Qhhf, Aa^Qhhf
Aa^Fda, Aa^Fda, Cva, Aa^Fma, Re, Aa^Fma, Aa, Aa, Gs, Gs, Gd, Gd, Gd^Qhh, Gd, Rp, Aa, Aa^Esa, Aa^Fma, Aa^Fma, Aa^Fda, Aa, Aa, Gd, Gs, Aa, Aa^Fda, Aa^Fda, Aa^Qhhf
Aa^Fma, Aa^Fda, Cva^Vka, Cva, Aa^Fma, Re, Aa, Gd, Gd, Gd, Gd, Gd, Gd, Rp^Qhh, Gd^Qhh, Gd, Aa^Esa, Aa^Fma, Aa^Fma, Aa, Gs, Aa^Esa, Aa^Esa, Aa^Esa, Gs, Gs, Aa^Esa, Aa^Qhhf
Gs, Cva, 4 Kva, Cva, Aa^Fma, Aa^Fma, Aa^Esa, Gd, Gs, Gd^Efm, Wwf, Gs, Gs, Rp, Gd^Qhh, Aa, Gs^Efm, Aa, Aa, Aa^_mh, Aa, Gs, Gd^Qhh, Aa^Qhh, Gd^Qhh, Aa^Esa, Aa^Qhh, Aa^Qhh
Aa^Fma, Gs, Re, Aa^Fma, Aa^Fma, Aa^Esa, Re, Gs, Gd, Wwf, Ww, Ww, Gd, Rp, Rp, Aa^Qhh, Aa^Qhh, Gs, Aa, Gd, Gd^Qhh, Aa^Qhh, Cea, Cea, Cea, Gd^Qhh, Aa^Fda, Aa^Fda
Gd, Aa^Fma, Re, Aa^Fma, Gs, Gs, Wwf, Ww, Ww, Ww, Wo, Ww, Ww, Gd, Rp, Gd^Qhh, Gd^Qhh, Aa^Qhh, Gd^Qhh, Gd^Qhh, Gd, Gd, Cea, 1 Kea, Cea, Gd^Qhh, Aa^Fda, Aa^Fda
Gd, Re, Gd, Gs, Gs, Ww, Aa, Aa^Vha, Ww, Ww, Ww, Wo, Ww, Wwf, Rp, Gd, Gd, Gd, Gs^Efm, Gd, Gd, Gs, Gs, Cea, Gs, Gd, Gd, Aa^Fda
Re, Re, Gd, Gd, Wwf, Ww, Ww, Ww, Aa^Esa, Aa^Esa, Ww, Ww, Ww, Rp, Aa, Gd, Aa, Aa, Aa, Gs, Gd, Gd, Gd, Gd, Aa, Gs, Gd, Gd
Aa^Fma, Gs, Gs, Gd, Wwf, Ww, Wo, Ww, Ww, Ww, Wo, Ww, Aa, Ww^Bw|, Ww, Aa, Wwf, Aa, Ww, Gd, Aa, Gd, Aa, Aa, Aa, Aa, Aa^Fda, Aa^Fda
Aa^Fma, Aa^Fma, Aa^Fma, Gd, Gd, Ww, Ww, Ww, Aa, Gd, Ww, Ww, Aa^Esa, Rp, Aa^Esa, Ww, Aa, Ww, Aa^Esa, Wwf, Ww, Aa, Ww, Aa^Vha, Aa, Aa, Aa^Fda, Aa^Fda
Ms, Ms, Ms, Ha, Ai, Ai, Gs, Gs, Aa^Esa, Aa^Esa, Gd, Aa^Esa, Gd, Rp, Rp, Aa^Esa, Gd, Aa, Aa, Aa^Esa, Gs, Wwf, Aa, Ww, Wwf, Aa, Aa, Aa^Fda
Re, Ms^Xm, Ms, Ms, Ai, Hhd, Ha, Aa, Aa, Aa, Aa, Gd, Aa, Aa, Rp, Gd, Gs, Aa, Aa, Gs, Gs, Aa, Aa, Aa, Gs, Ww, Ww, Aa
Ha, Re, Ai, Ai, Ha, Ms, Ms, Ha, Hhd, Aa^Fpa, Ha, Gs, Gs, Rp, Aa, Aa, Aa, Gs, Aa, Aa, Aa, Gs, Aa, Gs, Aa, Aa, Aa, Re
Aa, Aa, Ai, Re, Re, Ms^Xm, Ms^Xm, Ms, Ha^Fma, Hhd, Hhd, Aa, Aa, Rp, Gs, Aa, Gd, Gs, Gs, Aa, Aa, Gd, Aa, Aa, Aa, Aa, Gs, Gd
Ai, Wwf, Gd, Ha, Ha, Ms, Ms, Ms, Ms, Ha^Esa, Ha^Fma, Aa^Fpa, Aa, Rp, Aa, Aa, Aa, Gd^Esa, Aa^Esa, Aa, Aa, Aa^Vha, Aa, Aa^Fma, Aa^Fda, Aa^Fda, Aa, Aa^Fma
Aa, Gd, Aa, Hhd, Aa^Fma, Aa^Fma, Ms, Ha, Ha, Ha^Esa, Ms^Xm, Aa^Fpa, Aa^Fpa, Rp^Esa, Rp^Esa, Aa^Esa, Aa^Esa, Aa, Gs^Efm, Gs, Gd, Aa, Aa^Fma, Aa^Fma, Aa, Aa^Fda, Aa^Fda, Aa^Fma
Aa, Aa^Vha, Cva, Aa^Fma, Gs, Aa^Fma, Ms, Ms, Ms^Xm, Ms, Ms, Ms, Ha, Aa^Esa, Rp, Aa^Esa, Aa, Aa, Aa^Esa, Aa, Aa, Ha^Fma, Aa^Fma, Cva, 5 Kva, Cva, Aa^Fda, Aa
Aa, Cva, Aa^Fma, Aa^Fma, Cva^Qhu, Gs, Ha^Qhu, Ms, Ms, Ms, Ms^Xm, Ms, Ha, Aa, Rp, Aa, Gs^Efm, Gs^Esa, Aa, Gs, Gd, Ha, Ha^Fma, Cva, Cva, Cva, Aa^Fda, Ww
Aa, Cva, 3 Kva, Cva^Qhu, Gd, Gd^Qhu, Aa^Vha, Ha^Qhu, Ha, Ms, Ms, Ms, Ms, Ha^Fma, Hhd, Rp, Gd, Aa, Aa^Qhh, Aa^Qhh, Aa^Qhh, Ha, Aa^Qhh, Ha, Ha, Aa^Fda, Aa^Qhh, Aa^Qhh
Aa, Cva, Cva, Cva^Qhu, Gd^Esa, Aa^Esa, Aa, Ha^Qhu, Aa^Qhu, Ms, Ms, Ms, Ms^Xm, Ms, Ha, Rp, Rp, Ha^Qhh, Ha, Aa, Gd, Gd^Qhh, Aa, Aa^Qhh, Aa^Qhh, Aa^Qhh, Gs^Esa, Ha
Re, Aa^Es, Aa, Gd^Qhu, Gd^Esa, Gd^_ml, Gd^Es, Gd^Es, Aa^Qhu, Ha, Ha^Esa, Ms, Ms, Ms, Ha, Hhd, Rp, Gd^Qhh, Aa, Aa, Gs^Efm, Aa, Gs^Efm, Gd, Aa, Gs^Esa, Aa, Ha
Gd^Es, Re, Re, Re^Qhu, Gs^Qhu, Re^Esa, Re^Qhu, Ha^Es, Re^Qhu, Aa, Aa^Esa, Aa^Esa, Hhd, Hhd, Rp, Rp, Gd^Qhh, Aa^Qhh, Aa, Aa, Gd^Esa, Gs, Gs, Gd, Hhd, Aa, Aa, Aa
Aa^Fda, Gd^Es, Gd, Gd, Gs, Gs^Qhu, Aa, Gd^Qhu, Ha, Aa^Esa, Ha^Esa, Re^Esa, Rp, Rp, Hhd^Qhh, Ha^Qhh, Aa, Gs, Gs^_mh, Gd^Esa, Gd, Hhd, Ha, Ha^Esa, Aa, Gd, Aa^Fda, Aa^Fda
Aa^Qhhf, Aa^Qhhf, Aa^Qhhf, Aa^Qhh, Gs^Qhh, Gs^Qhh, Gd^Qhh, Aa, Aa, Hhd, Hhd, Ha^Esa, Rp, Gd^Qhh, Ha, Aa, Aa, Gs, Aa^Fma, Aa, Aa, Aa, Aa, Aa, Gs, Gs, Hhd, Aa^Fda
Gd^Qhh, Aa^Fda, Aa, Aa, Gd^Esa, Gd^Esa, Aa, Aa^Qhh, Aa^Qhh, Aa^Qhh, Rp, Rp, Hhd, Ha^Qhh, Gd^Qhh, Aa, Gd^Esa, Aa, Aa, Aa^Fma, Gd^Esa, Aa^Fma, Aa, Aa^Fma, Ha, Ha, Hhd, Hhd
Gd^Qhh, Aa^Fda, Gs, Aa, Aa, Gd^Esa, Aa, Ha, Ha, Hhd^Qhh, Rp, Hhd, Ha, Hhd^Vhha, Aa, Gd^Qhh, Aa, Aa^Fma, Aa, Gd^Esa, Ha, Ha, Aa^Qhhf, Aa^Vha, Ha^Qhhf, Hhd^Qhh, Ha^Qhh, Ha^Qhh
Aa^Qhhf, Gs, Aa^Fda, Aa, Aa, Aa, Gd^_mh, Aa, Aa, Aa^Qhh, Aa^Qhh, Rp, Rp, Aa, Aa, Gs^Qhh, Gs^Qhh, Aa^Qhh, Aa^Qhh, Aa^Fma, Hhd^Qhh, Ha^Qhhf, Ha^Fma, Aa^Qhhf, Ms, Ms^Xm, Ms^Xm, Ms^Xm
Aa^Qhhf, Aa^Fda, Aa^Fda, Aa^Fda, Re, Gd^Esa, Gd^Esa, Gs, Gs^Efm, Gs^Efm, Aa^Esa, Aa^Qhh, Rp, Gd, Gd, Aa, Gs, Aa, Aa, Hhd^Qhh, Ha, Ha^Fma, Ms, Ms, Ms, Ms, Ms^Xm, Ms^Xm
Aa^Qhhf, Re, Aa^Fda, Aa^Esa, Aa^Fda, Gd^Esa, Aa^Fda, Gs, Aa, Aa, Aa^Qhh, Aa^Qhh, Rp, Aa, Cva, Aa, Gs, Aa^Fma, Hhd, Aa, Ha^Fma, Ms, Ms, Ms, Ms^Xm, Ms, Ms^Xm, Ms^Xm
Aa^Qhhf, Re, Aa^Qhhf, Aa^Vha, Aa^Esa, Gd, Aa^Fda, Aa, Aa^Qhh, Aa^Qhh, Aa, Rp, Gd, Cva, 2 Kva, Cva, Ha, Aa^Fma, Ha^Fma, Aa, Ms, Ha, Ms, Ms^Xm, Ms^Xm, Ms^Xm, Ms^Xm, Ms^Xm
Aa^Qhhf, Aa^Qhhf, Gs^Efm, Aa^Qhhf, Aa^Qhhf, Aa^Qhhf, Aa^Qhhf, Aa^Qhhf, Aa, Aa, Aa, Rp, Gd^Efm, Cva, Cva, Cva, Aa, Ha, Ha^Fma, Ha^Fma, Ha^Fma, Ms, Ms, Ms^Xm, Ms^Xm, Ms^Xm, Ms^Xm, Ms^Xm
Aa^Fda, Aa^Fda, Gs, Aa^Fda, Aa^Fda, Aa^Fda, Aa^Fda, Aa^Fda, Aa^Fda, Gd, Gd, Rp, Gd, Aa^Fma, Aa^Fma, Aa^Fma, Aa^Fma, Aa, Aa, Ha, Ms^Xm, Ms, Ms^Xm, Ms^Xm, Ms^Xm, Ms^Xm, Ms^Xm, Ms^Xm
Gg, Aa^Fda, Aa, Aa^Fda, Ha, Aa^Fda, Aa^Fda, Aa^Fda, Aa^Fda, Gd, Gd, Rp, Rp, Aa^Fma, Aa^Fma, Aa^Fma, Aa, Aa, Aa, Ha, Gg, Ms^Xm, Ms^Xm, Ms^Xm, Ms^Xm, Ms^Xm, Ms^Xm, Ms^Xm
