Gs, Gs, Gs, Gs, Gs, Gs, Gs, Gs, Gs, Gs, Gs, Gs, Gs, Gs, Gs, Gs, Gs, Gs, Gs, Gs, Gs, Gs, Gs, Gs, Gs, Gs, Gs
Gs, Gs, Gs, Gs, Gs, Gs, Gs, Gs, Gs, Gs, Gs, Gs, Gs, Gs, Gs, Gs, Gs, Gs, Gs, Gs, Gs, Gs, Ce, Gs, Gs, Gs, Gs
Gs, Gs, Ce, Ce, Ce, Gs, Gs, Gs, Gs, Gs, Gs, Gs, Gs, Gs, Gs, Gs, Gs, Gs, Gs, Gs, Gs, Ce, Ket, Ce, Ce, Gs, Gs
Gs, Gs, Ce, 1 Ke, Ce, Gs, Gs, Gs, Gs, Gs, Gs, Gs, Gs, Gs, Gs, Gs, Gs, Gs, Gs, Gs, Gs, Ce, Ce, 4 Ket, Ce, Gs, Gs
Gs, Gs, Gs, Ce, Gs, Gs, Gs, Gs, Gs, Gs, Gs, Gs, Gs, Gs, Gs, Gs, Gs, Gs, Gs, Gs, Gs, Gs, Gs, Ce, Gs, Gs, Gs
Gs, Gs, Gs, Gs, Gs, Gs, Gs, Gs, Gs, Gs, Gs, Gs, Gs, Gs, Gs, Gs, Gs, Gs, Gs, Gs, Gs, Gs, Gs, Gs, Gs, Gs, Gs
Gs, Gs, Gs, Gs, Gs, Gs, Gs, Gs, Gs, Gs, Gs, Gs, Gs, Gs, Gs, Gs, Gs, Gs, Gs, Gs, Gs, Gs, Gs, Gs, Gs, Gs, Gs
Gs, Gs, Gs, Gs, Gs, Gs, Gs, Gs, Gs, Gs, Gs, Gs, Gs, Gs, Gs, Gs, Gs, Gs, Gs, Gs, Gs, Gs, Gs, Gs, Gs, Gs, Gs
Gs, Gs, Gs, Gs, Gs, Gs, Gs, Gs, Gs, Gs, Gs, Gs, Gs, Gs, Gs, Gs, Gs, Gs, Gs, Gs, Gs, Gs, Gs, Gs, Gs, Gs, Gs
Gs, Gs, Gs, Gs, Gs, Gs, Gs, Gs, Gs, Gs, Gs, Gs, Gs, Gs, Gs, Gs, Gs, Gs, Gs, Gs, Gs, Gs, Gs, Gs, Gs, Gs, Gs
Gs, Gs, Gs, Gs, Gs, Gs, Gs, Gs, Gs, Gs, Hhd, Hhd, Md, Md, Md, Hhd, Hhd, Gs, Gs, Gs, Gs, Gs, Gs, Gs, Gs, Gs, Gs
Gs, Gs, Gs, Gs, Gs, Gs, Gs, Gs, Rd, Md, Md, Md, Md, Md, Md, Md, Md, Md, Rd, Gs, Gs, Gs, Gs, Gs, Gs, Gs, Gs
Hhd, Hhd, Md, Hhd, Md, Gs, Gs, Rd, Rd, Md, Md, Md, Md, Md, Md, Md, Md, Md, Rd, Rd, Gs, Gs, Md, Hhd, Md, Hhd, Hhd
Md, Md, Md, Md, Md, Md, Md, Hhd, Re, Re, Hhd, Hhd, Md^Xm, Md^Xm, Md^Xm, Hhd, Hhd, Re, Re, Hhd, Md, Md, Md, Md, Md, Md, Md
Md^Xm, Md, Md, Md, Md^Xm, Md^Xm, Md^Xm, Hhd, Hhd, Rb, Rb, Hhd, Md^Xm, Md^Xm, Md^Xm, Hhd, Rb, Rb, Hhd, Hhd, Md^Xm, Md^Xm, Md^Xm, Md, Md, Md, Md^Xm
Md^Xm, Md^Xm, Md, Md, Md^Xm, Md^Xm, Xoc, Xoc, Cf^Ebn, Cf, Cf, Cf, Xoc, Xoc, Xoc, Cf, Cf, Cf, Cf^Ebn, Xoc, Xoc, Md^Xm, Md^Xm, Md, Md, Md^Xm, Md^Xm
Xu, Md^Xm, Uu, Uu, Xoc, Xoc, Xoc^Efs, Xoc, Isr, Cf, Isr, Cf, Xoc^Efs, Xoc, Xoc^Efs, Cf, Isr, Cf, Isr, Xoc, Xoc^Efs, Xoc, Xoc, Uu, Uu, Md^Xm, Xu
Xu, Xu, Uu, Uu, Xoc, Xoc, Isr, Isr, Isr, Isr, Isr, Isr, Isr, Xoc, Isr, Isr, Isr, Isr, Isr, Isr, Isr, Xoc, Xoc, Uu, Uu, Xu, Xu
Xu, Xu, Uu, Uu, Xoc, Isr, Isr, Isr, Isr, Isr, Isr, Isr, Isr, Isr, Isr, Isr, Isr, Isr, Isr, Isr, Isr, Isr, Xoc, Uu, Uu, Xu, Xu
Xu, Xu, Uu, Uu, Xoc, Isr, Isr, Xoc, Isr, Isc, Isr, Xoc, Isr, Isc, Isr, Xoc, Isr, Isc, Isr, Xoc, Isr, Isr, Xoc, Uu, Uu, Xu, Xu
Xu, Xu, Uu, Uu, Xoc^Efs, Isr, Isr, Xoc, Isr, Isc, Isr, Xoc, Isr, Isc, Isr, Xoc, Isr, Isc, Isr, Xoc, Isr, Isr, Xoc^Efs, Uu, Uu, Xu, Xu
Xu, Xu, Isa^Pr/, Isa^Pr/, Isr, Isr, Isr, Xoc, Isr, Isc, Isr, Xoc, Isr, Isc, Isr, Xoc, Isr, Isc, Isr, Xoc, Isr, Isr, Isr, Isa^Pr\, Isa^Pr\, Xu, Xu
Xu, Xu, Xu, Isr, Isr, Isr, Isr, Xoc, Isr, Isc, Isr, Xoc, Isr, Isc, Isr, Xoc, Isr, Isc, Isr, Xoc, Isr, Isr, Isr, Isr, Xu, Xu, Xu
Xu, Xu, Xoc, Xoc, Xoc^Efs, Isr, Isr, Xoc, Isr, Isc, Isr, Xoc, Isr, Isc, Isr, Xoc, Isr, Isc, Isr, Xoc, Isr, Isr, Xoc^Efs, Xoc, Xoc, Xu, Xu
Xu, Xoc, Xoc, Xoc, Isr, Isr, Isr, Xoc^Efs, Isr, Isc, Isr, Xoc, Isr, Isc, Isr, Xoc, Isr, Isc, Isr, Xoc^Efs, Isr, Isr, Isr, Xoc, Xoc, Xoc, Xu
Xu, Xu, Xoc, Isr, Isr, Isr, Isr, Isr, Isr, Isc, Isr, Xoc^Efs, Isr, Isc, Isr, Xoc^Efs, Isr, Isc, Isr, Isr, Isr, Isr, Isr, Isr, Xoc, Xu, Xu
Xu, Xu, Xoc, Isr, Isr, Xoc, Isr, Isr, Isc, Isr, Isr, Isr, Isr, Isr, Isr, Isr, Isr, Isr, Isc, Isr, Isr, Xoc, Isr, Isr, Xoc, Xu, Xu
Xu, Xu, Xoc, Isr, Isr, Xoc, Isr, Isc, Isc, Isc, Isr, Isr, Isr, Isr, Isr, Isr, Isr, Isc, Isc, Isc, Isr, Xoc, Isr, Isr, Xoc, Xu, Xu
Xu, Xu, Xoc, Isr, Isr, Xoc, Isr, Isr, Isr, Isr, Xoc^Efs, Xoc, Isr, Isr, Isr, Xoc, Xoc^Efs, Isr, Isr, Isr, Isr, Xoc, Isr, Isr, Xoc, Xu, Xu
Xu, Xu, Xoc, Isr, Isr, Xoc, Isr, Isr, Xoc, Xoc, Isr, Isr, Isr, Isr, Isr, Isr, Isr, Xoc, Xoc, Isr, Isr, Xoc, Isr, Isr, Xoc, Xu, Xu
Xu, Xu, Xoc, Isr, Isr, Xoc, Isr, Isr, Xoc, Isr, Isr, Isr, Cf, Isr, Cf, Isr, Isr, Isr, Xoc, Isr, Isr, Xoc, Isr, Isr, Xoc, Xu, Xu
Xu, Xu, Xoc, Isr, Isr, Xoc, Isr, Isr, Xoc^Efs, Isr, Isr, Cf, Cf, Cf, Cf, Cf, Isr, Isr, Xoc^Efs, Isr, Isr, Xoc, Isr, Isr, Xoc, Xu, Xu
Xu, Xu, Xoc, Isr, Isr, Xoc, Isr, Isr, Isr, Isr, Isr, Cf, Cf, 2 Kf, Cf, Cf, Isr, Isr, Isr, Isr, Isr, Xoc, Isr, Isr, Xoc, Xu, Xu
Xu, Xu, Xoc, Isr, Isr, Xoc, Isr, Isr, Isr, Isr, Isr, Cf, Cf, Cf, Cf, Cf, Isr, Isr, Isr, Isr, Isr, Xoc, Isr, Isr, Xoc, Xu, Xu
Xu, Xu, Xoc, Isr, Cf, Isr, Isr, Isr, Isr, Isr, Isr, Isr, Isr, Isr, Isr, Isr, Isr, Isr, Isr, Isr, Isr, Isr, Cf, Isr, Xoc, Xu, Xu
Xu, Xu, Xoc, Isr, Cf^Ebn, Cf, Isr, Xoc, Isr, Isr, Isr, Isr, Isr, Isr, Isr, Isr, Isr, Isr, Isr, Xoc, Isr, Cf, Cf^Ebn, Isr, Xoc, Xu, Xu
Xu, Xu, Xoc, Isr, Isr, Cf, Isr, Xoc, Xoc^Efs, Isr, Isr, Isr, Xoc, Xoc, Xoc, Isr, Isr, Isr, Xoc^Efs, Xoc, Isr, Cf, Isr, Isr, Xoc, Xu, Xu
Xu, Xu, Xu, Xoc, Xoc, Isr, Isr, Isr, Isr, Xoc, Xoc, Xoc, Isr, Isr, Isr, Xoc, Xoc, Xoc, Isr, Isr, Isr, Isr, Xoc, Xoc, Xu, Xu, Xu
Xu, Xu, Xu, Xu, Xu, Xoc, Xoc, Isr, Isr, Isr, Isr, Isr, Isc, Isc, Isc, Isr, Isr, Isr, Isr, Isr, Xoc, Xoc, Xu, Xu, Xu, Xu, Xu
Xu, Xu, Xu, Xu, Xu, Xu, Xu, Xoc, Xoc, Isr, Isr, Isc^Ebn, Isc, Isc^Ii, Isc, Isc^Ebn, Isr, Isr, Xoc, Xoc, Xu, Xu, Xu, Xu, Xu, Xu, Xu
Xu, Xu, Xu, Xu, Xu, Xu, Xu, Xu, Xu, Xoc, Xoc, Isr, Isr, Isc, Isr, Isr, Xoc, Xoc, Xu, Xu, Xu, Xu, Xu, Xu, Xu, Xu, Xu
Xu, Xu, Xu, Xu, Xu, Xu, Xu, Xu, Xu, Xu, Xu, Xoc, Isr, Isr, Isr, Xoc, Xu, Xu, Xu, Xu, Xu, Xu, Xu, Xu, Xu, Xu, Xu
Xu, Xu, Xu, Xu, Xu, Xu, Xu, Xu, Xu, Xu, Xu, Xoc, Isr, Isr, Isr, Xoc, Xu, Xu, Xu, Xu, Xu, Xu, Xu, Xu, Xu, Xu, Xu
Xu, Xu, Xu, Xu, Xu, Xu, Xu, Xu, Xu, Xu, Xu, Xoc, Xoc, Isr, Xoc, Xoc, Xu, Xu, Xu, Xu, Xu, Xu, Xu, Xu, Xu, Xu, Xu
Xu, Xu, Xu, Xu, Xu, Xu, Xu, Xu, Xu, Xu, Xu, Xu, Xu, Xoc, Xu, Xu, Xu, Xu, Xu, Xu, Xu, Xu, Xu, Xu, Xu, Xu, Xu
Xu, Xu, Xu, Xu, Xu, Xu, Xu, Xu, Xu, Xu, Xu, Xu, Xu, Xu, Xu, Xu, Xu, Xu, Xu, Xu, Xu, Xu, Xu, Xu, Xu, Xu, Xu
