Gd, Gd, Gd, Gd, Gd, Gd, Gd, Gd, Gd, Gd, Gd, Gd, Gd, Ms, Ms, Ms, Ms^Xm, Ms^Xm, Ms^Xm, Ms^Xm, Ms^Xm, Ms^Xm, Ms^Xm, Ms^Xm, Ms^Xm, Ms^Xm, Ms^Xm
Gd, Gd, Gd, Gd, Gd, Gd, Gd, Gd, Gd, Gd, Gd, Gd, Gd, Gd, Ms, Ms^Xm, Ms^Xm, Ms^Xm, Ms, Ms^Xm, Ms^Xm, Ms^Xm, Ce, Ms^Xm, Ms^Xm, Ms^Xm, Ms^Xm
Gd, Gd, Ce, Ce, Ce, Gd, Gd, Gd, Gd, Gd, Gd, Gd, Gd, Gd, Gd, Ms, Ms, Ms, Ms, Ms, Ms, Ce, Ket, Ce, Ce, Ms^Xm, Ms^Xm
Gd, Gd, Ce, 1 Ke, Ce, Gd, Gd, Gd, Gd, Gd, Gd, Gd, Gd, Gd, Gd, Gd, Gd, Ms, Gd, Gd, Gd, Ce, Ce, 4 Ket, Ce, Ms^Xm, Ms^Xm
Gd, Gd, Gd, Ce, Gd, Gd, Gd, Gd, Gd, Gd, Gd, Gd, Gd, Gd, Gd, Gd, Gd, Gd, Gd, Gd, Gd, Gd, Gd, Ce, Ms^Xm, Ms^Xm, Ms^Xm
Gd, Gd, Gd, Gd, Gd, Gd, Gd, Gd, Gd, Gd, Gd, Gd, Gd, Gd, Gd, Gd, Gd, Gd, Gd, Gd, Gd, Gd, Gd, Ms, Ms^Xm, Ms^Xm, Ms^Xm
Gd, Gd, Gd, Gd, Gd, Gd, Gd, Gd, Gd, Gd, Gd, Gd, Gd, Gd, Gd, Gd, Gd, Gd, Gd, Gd, Gd, Gd, Gd, Ms, Ms^Xm, Ms^Xm, Ms^Xm
Gd, Gd, Gd, Gd, Gd, Gd, Gd, Gd, Gd, Gd, Gd, Gd, Gd, Gd, Gd, Gd, Gd, Gd, Gd, Gd, Gd, Gd, Gd, Ms, Ms, Ms^Xm, Ms^Xm
Gd, Gd, Gd, Gd, Gd, Gd, Gd, Gd, Gd, Gd, Gd, Gd, Gd, Gd, Gd, Gd, Gd, Gd, Gd, Gd, Gd, Gd, Gd, Gd, Gd, Ms, Ms
Gd, Gd, Gd, Gd, Gd, Gd, Gd, Gd, Gd, Gd, Gd, Gd, Gd, Gd, Gd, Gd, Gd, Gd, Gd, Gd, Gd, Gd, Gd, Gd, Gd, Gd, Gd
Gd, Gd, Gd, Gd, Gd, Gd, Gd, Gd, Gd, Gd, Ha, Ha, Ms, Ms, Ms, Ha, Ha, Gd, Gd, Gd, Gd, Gd, Gd, Gd, Gd, Gd, Gd
Gd, Gd, Gd, Gd, Gd, Gd, Gd, Gd, Rd, Ms, Ms, Ms, Ms, Ms, Ms, Ms, Ms, Ms, Rd, Gd, Gd, Gd, Gd, Gd, Gd, Gd, Gd
Ha, Ha, Ms, Ha, Ms, Gd, Gd, Rd, Rd, Ms, Ms, Ms, Ms, Ms, Ms, Ms, Ms, Ms, Rd, Rd, Gd, Gd, Ms, Ha, Ms, Ha, Ha
Ms, Ms, Ms, Ms, Ms, Ms, Ms, Ha, Re, Re, Ha, Ha, Ms^Xm, Ms^Xm, Ms^Xm, Ha, Ha, Re, Re, Ha, Ms, Ms, Ms, Ms, Ms, Ms, Ms
Ms^Xm, Ms, Ms, Ms, Ms^Xm, Ms^Xm, Ms^Xm, Ha, Ha, Rb, Rb, Ha, Ms^Xm, Ms^Xm, Ms^Xm, Ha, Rb, Rb, Ha, Ha, Ms^Xm, Ms^Xm, Ms^Xm, Ms, Ms, Ms, Ms^Xm
Ms^Xm, Ms^Xm, Ms, Ms, Ms^Xm, Ms^Xm, Xoc, Xoc, Cf^Ebn, Cf, Cf, Cf, Xoc, Xoc, Xoc, Cf, Cf, Cf, Cf^Ebn, Xoc, Xoc, Ms^Xm, Ms^Xm, Ms, Ms, Ms^Xm, Ms^Xm
Xu, Ms^Xm, Uu, Uu, Xoc, Xoc, Xoc^Efs, Xoc, Isr, Cf, Isr, Cf, Xoc^Efs, Xoc, Xoc^Efs, Cf, Isr, Cf, Isr, Xoc, Xoc^Efs, Xoc, Xoc, Uu, Uu, Ms^Xm, Xu
Xu, Xu, Uu, Uu, Xoc, Xoc, Isr, Isr, Isr, Isr, Isr, Isr, Isr, Xoc, Isr, Isr, Isr, Isr, Isr, Isr, Isr, Xoc, Xoc, Uu, Uu, Xu, Xu
Xu, Xu, Uu, Uu, Xoc, Isr, Isr, Isr, Isr, Isr, Isr, Isr, Isr, Isr, Isr, Isr, Isr, Isr, Isr, Isr, Isr, Isr, Xoc, Uu, Uu, Xu, Xu
Xu, Xu, Uu, Uu, Xoc, Isr, Isr, Xoc, Isr, Isc, Isr, Xoc, Isr, Isc, Isr, Xoc, Isr, Isc, Isr, Xoc, Isr, Isr, Xoc, Uu, Uu, Xu, Xu
Xu, Xu, Uu, Uu, Xoc^Efs, Isr, Isr, Xoc, Isr, Isc, Isr, Xoc, Isr, Isc, Isr, Xoc, Isr, Isc, Isr, Xoc, Isr, Isr, Xoc^Efs, Uu, Uu, Xu, Xu
Xu, Xu, Isa^Pr/, Isa^Pr/, Isr, Isr, Isr, Xoc, Isr, Isc, Isr, Xoc, Isr, Isc, Isr, Xoc, Isr, Isc, Isr, Xoc, Isr, Isr, Isr, Isa^Pr\, Isa^Pr\, Xu, Xu
Xu, Xu, Xu, Isr, Isr, Isr, Isr, Xoc, Isr, Isc, Isr, Xoc, Isr, Isc, Isr, Xoc, Isr, Isc, Isr, Xoc, Isr, Isr, Isr, Isr, Xu, Xu, Xu
Xu, Xu, Xoc, Xoc, Xoc^Efs, Isr, Isr, Xoc, Isr, Isc, Isr, Xoc, Isr, Isc, Isr, Xoc, Isr, Isc, Isr, Xoc, Isr, Isr, Xoc^Efs, Xoc, Xoc, Xu, Xu
Xu, Xoc, Xoc, Xoc, Isr, Isr, Isr, Xoc^Efs, Isr, Isc, Isr, Xoc, Isr, Isc, Isr, Xoc, Isr, Isc, Isr, Xoc^Efs, Isr, Isr, Isr, Xoc, Xoc, Xoc, Xu
Xu, Xu, Xoc, Isr, Isr, Isr, Isr, Isr, Isr, Isc, Isr, Xoc^Efs, Isr, Isc, Isr, Xoc^Efs, Isr, Isc, Isr, Isr, Isr, Isr, Isr, Isr, Xoc, Xu, Xu
Xu, Xu, Xoc, Isr, Isr, Xoc, Isr, Isr, Isc, Isr, Isr, Isr, Isr, Isr, Isr, Isr, Isr, Isr, Isc, Isr, Isr, Xoc, Isr, Isr, Xoc, Xu, Xu
Xu, Xu, Xoc, Isr, Isr, Xoc, Isr, Isc, Isc, Isc, Isr, Isr, Isr, Isr, Isr, Isr, Isr, Isc, Isc, Isc, Isr, Xoc, Isr, Isr, Xoc, Xu, Xu
Xu, Xu, Xoc, Isr, Isr, Xoc, Isr, Isr, Isr, Isr, Xoc^Efs, Xoc, Isr, Isr, Isr, Xoc, Xoc^Efs, Isr, Isr, Isr, Isr, Xoc, Isr, Isr, Xoc, Xu, Xu
Xu, Xu, Xoc, Isr, Isr, Xoc, Isr, Isr, Xoc, Xoc, Isr, Isr, Isr, Isr, Isr, Isr, Isr, Xoc, Xoc, Isr, Isr, Xoc, Isr, Isr, Xoc, Xu, Xu
Xu, Xu, Xoc, Isr, Isr, Xoc, Isr, Isr, Xoc, Isr, Isr, Isr, Cf, Isr, Cf, Isr, Isr, Isr, Xoc, Isr, Isr, Xoc, Isr, Isr, Xoc, Xu, Xu
Xu, Xu, Xoc, Isr, Isr, Xoc, Isr, Isr, Xoc^Efs, Isr, Isr, Cf, Cf, Cf, Cf, Cf, Isr, Isr, Xoc^Efs, Isr, Isr, Xoc, Isr, Isr, Xoc, Xu, Xu
Xu, Xu, Xoc, Isr, Isr, Xoc, Isr, Isr, Isr, Isr, Isr, Cf, Cf, 2 Kf, Cf, Cf, Isr, Isr, Isr, Isr, Isr, Xoc, Isr, Isr, Xoc, Xu, Xu
Xu, Xu, Xoc, Isr, Isr, Xoc, Isr, Isr, Isr, Isr, Isr, Cf, Cf, Cf, Cf, Cf, Isr, Isr, Isr, Isr, Isr, Xoc, Isr, Isr, Xoc, Xu, Xu
Xu, Xu, Xoc, Isr, Cf, Isr, Isr, Isr, Isr, Isr, Isr, Isr, Isr, Isr, Isr, Isr, Isr, Isr, Isr, Isr, Isr, Isr, Cf, Isr, Xoc, Xu, Xu
Xu, Xu, Xoc, Isr, Cf^Ebn, Cf, Isr, Xoc, Isr, Isr, Isr, Isr, Isr, Isr, Isr, Isr, Isr, Isr, Isr, Xoc, Isr, Cf, Cf^Ebn, Isr, Xoc, Xu, Xu
Xu, Xu, Xoc, Isr, Isr, Cf, Isr, Xoc, Xoc^Efs, Isr, Isr, Isr, Xoc, Xoc, Xoc, Isr, Isr, Isr, Xoc^Efs, Xoc, Isr, Cf, Isr, Isr, Xoc, Xu, Xu
Xu, Xu, Xu, Xoc, Xoc, Isr, Isr, Isr, Isr, Xoc, Xoc, Xoc, Isr, Isr, Isr, Xoc, Xoc, Xoc, Isr, Isr, Isr, Isr, Xoc, Xoc, Xu, Xu, Xu
Xu, Xu, Xu, Xu, Xu, Xoc, Xoc, Isr, Isr, Isr, Isr, Isr, Isc, Isc, Isc, Isr, Isr, Isr, Isr, Isr, Xoc, Xoc, Xu, Xu, Xu, Xu, Xu
Xu, Xu, Xu, Xu, Xu, Xu, Xu, Xoc, Xoc, Isr, Isr, Isc^Ebn, Isc, Isc^Ii, Isc, Isc^Ebn, Isr, Isr, Xoc, Xoc, Xu, Xu, Xu, Xu, Xu, Xu, Xu
Xu, Xu, Xu, Xu, Xu, Xu, Xu, Xu, Xu, Xoc, Xoc, Isr, Isr, Isc, Isr, Isr, Xoc, Xoc, Xu, Xu, Xu, Xu, Xu, Xu, Xu, Xu, Xu
Xu, Xu, Xu, Xu, Xu, Xu, Xu, Xu, Xu, Xu, Xu, Xoc, Isr, Isr, Isr, Xoc, Xu, Xu, Xu, Xu, Xu, Xu, Xu, Xu, Xu, Xu, Xu
Xu, Xu, Xu, Xu, Xu, Xu, Xu, Xu, Xu, Xu, Xu, Xoc, Isr, Isr, Isr, Xoc, Xu, Xu, Xu, Xu, Xu, Xu, Xu, Xu, Xu, Xu, Xu
Xu, Xu, Xu, Xu, Xu, Xu, Xu, Xu, Xu, Xu, Xu, Xoc, Xoc, Isr, Xoc, Xoc, Xu, Xu, Xu, Xu, Xu, Xu, Xu, Xu, Xu, Xu, Xu
Xu, Xu, Xu, Xu, Xu, Xu, Xu, Xu, Xu, Xu, Xu, Xu, Xu, Xoc, Xu, Xu, Xu, Xu, Xu, Xu, Xu, Xu, Xu, Xu, Xu, Xu, Xu
Xu, Xu, Xu, Xu, Xu, Xu, Xu, Xu, Xu, Xu, Xu, Xu, Xu, Xu, Xu, Xu, Xu, Xu, Xu, Xu, Xu, Xu, Xu, Xu, Xu, Xu, Xu
