Xu, Xu, Xu, Xu, Xu, Xu, Xu, Xu, Xu, Xu, Xu, Xu, Xu, Xu, Xu, Xu, Xu, Xu, Xu, Xu, Xu, Xu, Xu, Xu, Xu, Xu, Xu, Xu, Xu, Xu, Xu, Xu, Xu, Xu, Xu
Xu, Xu, Xu, Xu, Xu, Xu, Xu, Xu, Xu, Xu, Qxua, Xu, Xu, Xu, Xu, Xu, Xu, Xu, Xu, Xu, Xu, Xu, Qxua, Xu, Qxua, Xu, Xu, Xu, Xu, Xu, Xu, Xu, Xu, Xu, Xu
Xu, Xu, Xu, Xu, Qxua, Qxua, Qxua, Xu, Qxua, Qxua, Qxua, Qxua, Qxua, Qxua, Qxua, Xu, Sm, Rb^Qhh, Ss, Xu, Sm^Qhu, Qxua, Qxua, Qxua, Qxua^Es, Qxua, Qxua, Qxua, Qxua, Xu, Qxua, Xu, Xu, Xu, Xu
Xu, Xu, Xu, Qxua, Qxua, Qxua, Qxua, Qxua, Qxua, Qxua^Es, Qxua^Es, Qxua^Es, Qxua, Qxua, Qxua, Qxua, Rb^Qhh, Ss^Em, Ss^Em, Sm^Qhu, Ss^Em, Qxua, Qxua, Qxua, Qxua, Qxua^Es, Qxua^Es, Qxua, Qxua, Qxua, Qxua, Qxua, Qxua, Xu, Xu
Xu, Xu, Xu, Qxua, Qxua, Cud^Kov, Cud, Xoa, Xoa, Qxua, Qxua, Qxua, Uu, Uu, Ur, Ss^Em, Ss, Sm^Qhu, Sm^Qhu, Rb^Qhh, Sm^Qhu, Ur, Ur, Uu, Ur, Qxua, Qxua, Qxua, Xoa, Qxua, Cud^Kov, Qxua, Qxua, Xu, Xu
Xu, Xu, Xu, Xu, Xoa, Cud, Isa, Xoa, Xoa, Xoa^Efs, Ur, Ur, Uu, Uu, Uu, Uu, Qxua, Rb^Qhh, Rb^Qhh, Rb^Qhh, Ss^Em, Uu, Uu, Uu, Uu, Uu, Uu, Xoa^Efs, Xoa, Cud, Cud, Qxua, Xu, Xu, Xu
Xu, Xu, Xu, Xu, Qxua, Xoa, Xoa, Isa^Pw/, Uu, Ur, Uu, Uu, Qxua, Qxua, Qxua, Qxua, Qxua^Es, Qxua, Qxua, Ss, Qxua, Qxua, Qxua, Qxua, Qxua, Uu, Ur, Isa, Isa, Isa^Pw\, Xoa, Xoa, Xu, Xu, Xu
Xu, Xu, Xu, Qxua, Qxua^Es, Qxua, Qxua, Uu, Uu, Uu, Qxua, Qxua, Qxua, Qxua, Qxua, Qxua, Qxua^Es, Qxua, Qxua^Xo, Qxua, Qxua, Qxua^Es, Qxua^Es, Qxua, Qxua, Uu, Uu, Isa, Qxua, Qxua, Qxua, Xu, Xu, Xu, Xu
Xu, Xu, Xu, Qxua, Qxua^Es, Qxua, Qxua, Qxua, Ur, Uu, Qxua, Qxua^Es, Qxua^Es, Qxua, Qxua, Qxua^Es, Qxua^Xo, Qxua^Xo, Cud^Eb, Qxua^Xo, Qxua^Xo, Qxua, Qxua, Qxua^Es, Qxua, Uu, Ur, Ur, Qxua, Qxua, Qxua, Xu, Xu, Xu, Xu
Xu, Xu, Xu, Qxua, Qxua, Qxua^Es, Qxua, Uu, Uu, Ur, Uu, Qxua, Qxua, Qxua^Es, Qxua, Qxua^Xo, Cud^Eb, Cud, Isa, Cud, Cud^Eb, Qxua^Xo, Qxua^Es, Qxua^Es, Qxua, Qxua, Uu, Ur, Qxua, Qxua, Xu, Xu, Xu, Xu, Xu
Xu, Xu, Xu, Xu, Xu, Qxua, Qxua^Es, Qxua, Qxua, Ur, Ur, Uu, Qxua, Qxua^Es, Qxua^Es, Qxua^Xo, Cud, Isa, Isa, Isa, Cud, Qxua^Xo, Qxua, Qxua, Qxua, Qxua, Uu, Uu, Qxua, Xu, Xu, Xu, Xu, Xu, Xu
Xu, Xu, Xu, Xu, Qxua, Qxua, Qxua^Es, Qxua, Qxua, Qxua, Uu, Ur, Ur, Qxua, Qxua, Qxua^Xo, Cud^Eb, Isa, Isa, Isa, Cud^Eb, Qxua^Xo, Qxua^Es, Qxua, Qxua, Uu, Ur, Ur, Qxua, Xu, Xu, Xu, Xu, Xu, Xu
Xu, Xu, Xu, Xu, Qxua, Qxua, Qxua, Qxua^Es, Qxua^Es, Qxua, Qxua, Uu, Uu, Uu, Qxua, Qxua^Xo, Qxua^Xo, Cud, Cud^Eb, Cud, Qxua^Xo, Qxua^Xo, Qxua^Es, Qxua, Uu, Ur, Uu, Qxua, Qxua^Es, Qxua, Xu, Xu, Xu, Xu, Xu
Xu, Xu, Xu, Xu, Xu, Qxua, Qxua, Qxua, Qxua, Qxua, Qxua^Es, Qxua, Uu, Ur, Qxua, Qxua^Es, Qxua, Qxua^Xo, Qxua^Xo, Qxua^Xo, Qxua, Qxua, Qxua^Es, Qxua, Ur, Uu, Qxua, Qxua, Qxua^Es, Qxua, Xu, Xu, Xu, Xu, Xoa
Xu, Xu, Xu, Xu, Xu, Xu, Xu, Xu, Xu, Qxua, Qxua, Qxua, Cud, Uu, Qxua, Qxua^Es, Qxua^Es, Qxua, Qxua, Qxua^Es, Qxua^Es, Qxua^Es, Qxua, Ur, Uu, Uu, Qxua, Qxua^Es, Qxua, Qxua, Xu, Xu, Xoa, Xoa, Isa
Xoa, Xu, Xu, Xu, Xu, Xu, Xoa, Xoa, Uu, Qxua, Qxua, Cud, Kud, Cud, Isa, Qxua, Qxua, Qxua^Es, Qxua^Es, Qxua, Qxua, Qxua, Qxua, Uu, Uu, Uu, Isa, Qxua, Qxua, Xu, Xoa, Xoa, Uu, Isa, Isa
Isa, Xoa, Xoa, Xu, Xoa, Xoa, Uu^Pw\o, Isa, Isa, Uu, Isa, Cud, Uu, Isa, Isa, Isa, Uu, Qxua, Qxua, Qxua, Qxua, Qxua, Isa, Isa, Uu, Uu, Isa, Isa, Isa, Xoa, Isa^Pw\, Uu, Uu, Isa, Xoa
Isa, Isa, Isa, Xoa, Isa, Isa, Uu, Isa^Pw\o, Xoa, Uu, Isa, Isa, Uu, Uu, Cud, Uu, Uu, Isa, Isa, Qxua, Uu, Isa, Isa, Isa, Uu, Uu, Uu, Isa, Uu, Uu, Isa, Isa^Pw\, Xoa, Xoa, Xu
Xoa, 2 Isa, Uu, 1 Uu, Uu, Uu, Xoa, Xoa, Xu, Xu, Qxua, Isa, Cud, Kud, Cud, Ur, Ur, Isa, Isa, Isa, Uu, Uu, Qxua, Qxua, Qxua, Ur, Ur, Qxua, Qxua, Isa, Xoa, Xoa, Xu, Xu, Xu
Xu, Xoa, Xoa, Uu, Xoa, Xoa, Xu, Xu, Qxua, Qxua, Qxua^Es, Qxua, Qxua, Cud, Uu, Ur, Qxua, Qxua, Qxua, Uu, Qxua, Qxua, Qxua^Es, Qxua^Es, Qxua, Ur, Uu, Qxua, Qxua, Qxua, Xu, Xu, Xu, Xu, Xu
Xu, Xu, Xu, Xoa, Xu, Xu, Xu, Xu, Qxua, Qxua^Es, Qxua^Es, Qxua, Uu, Uu, Ur, Ur, Qxua, Qxua, Qxua^Es, Qxua, Qxua, Qxua, Qxua^Es, Qxua, Uu, Uu, Ur, Xoa, Qxua, Qxua, Qxua, Xu, Xu, Xu, Xu
Xu, Xu, Xu, Xu, Qxua, Qxua, Qxua, Qxua, Qxua, Qxua, Qxua, Qxua, Ur, Ur, Xu, Qxua, Qxua, Qxua^Es, Qxua, Qxua, Xu, Qxua, Qxua, Qxua, Uu, Ur, Uu, Xoa^Efs, Xoa, Qxua, Qxua, Qxua, Xu, Xu, Xu
Xu, Xu, Xu, Xu, Qxua, Qxua, Xoa, Xoa^Efs, Uu, Uu, Uu, Uu, Uu, Uu, Xu, Xu, Xu, Qxua, Xu, Xu, Xot^Efs, Xu, Xu, Xu, Xot, Uu, Ur, Uu, Uu, Cud, Cud^Kov, Qxua, Qxua, Xu, Xu
Xu, Xu, Xu, Qxua, Qxua, Qxua, Cud, Ur, Ur, Ur, Uu, Ur, Xot, Xot^Efs, Xot, Xot^Efs, Xot, Xu, Xot^Efs, Xot, Uu, Xot, Xot, Xot^Efs, Ur, Uu, Ur, Uu, Xoa, Cud, Qxua, Qxua, Qxua, Xu, Xu
Xu, Xu, Xu, Qxua, Qxua, Cud^Kov, Cud, Uu, Xoa, Xoa, Uu, Ur, Uu, Uu, Uu, Uu, Uu, Xot, Ur, Ur, Ur, Uu, Ur, Uu, Ur, Ur, Xoa, Xoa, Xoa, Qxua, Qxua, Qxua, Xu, Xu, Xu
Xu, Xu, Xu, Qxua, Qxua, Qxua, Qxua, Xoa, Qxua, Qxua, Qxua, Uu, Ur, Uu, Ur, Ur, Ur, Uu, Ur, Ur, Xu, Uu, Xu, Ur, Uu, Uu, Xoa, Xoa, Xoa, Qxua, Qxua, Qxua, Xu, Xu, Xu
Xu, Xu, Xu, Xu, Xu, Qxua, Xu, Xoa, Xoa, Qxua, Xu, Xu, Xu, Xu, Xu, Xu, Xu, Ur, Xu, Xu, Xu, Xu, Xu, Xu, Xu, Xu, Xu, Xu, Xu, Xu, Xu, Xu, Xu, Xu, Xu
Xu, Xu, Xu, Xu, Xu, Xu, Xu, Xu, Xu, Xu, Xu, Xu, Xu, Xu, Xu, Xu, Xu, Xu, Xu, Xu, Xu, Xu, Xu, Xu, Xu, Xu, Xu, Xu, Xu, Xu, Xu, Xu, Xu, Xu, Xu
Xu, Xu, Xu, Xu, Xu, Xu, Xu, Xu, Xu, Xu, Xu, Xu, Xu, Xu, Xu, Xu, Xu, Xu, Xu, Xu, Xu, Xu, Xu, Xu, Xu, Xu, Xu, Xu, Xu, Xu, Xu, Xu, Xu, Xu, Xu
