Xu, Xu, Xu, Xu, Xu, Xu, Xu, Xu, Xu, Xu, Xu, Xu, Xu, Xu, Xu, Xu, Xu, Xu, Xu, Xu, Xu, Xu, Xu, Xu, Xu, Xu, Xu, Xu, Xu, Xu, Xu, Xu, Xu, Xu, Xu
Xu, Xu, Xu, Xu, Xu, Xu, Xu, Xu, Xu, Xu, Qxua, Xu, Xu, Xu, Xu, Xu, Xu, Xu, Xu, Xu, Xu, Xu, Qxua, Xu, Qxua, Xu, Xu, Xu, Xu, Xu, Xu, Xu, Xu, Xu, Xu
Xu, Xu, Xu, Xu, Qxua, Qxua, Qxua, Xu, Qxua, Qxua, Qxua, Qxua, Qxua, Qxua, Qxua, Xu, Sm, Rb^Qhh, Ss, Xu, Sm^Qhu, Qxua, Qxua, Qxua, Qxua^Es, Qxua, Qxua, Qxua, Qxua, Xu, Qxua, Xu, Xu, Xu, Xu
Xu, Xu, Xu, Qxua, Qxua, Qxua, Qxua, Qxua, Qxua, Qxua^Es, Qxua^Es, Qxua^Es, Qxua, Qxua, Qxua, Qxua, Rb^Qhh, Ss^Em, Ss^Em, Sm^Qhu, Ss^Em, Qxua, Qxua, Qxua, Qxua, Qxua^Es, Qxua^Es, Qxua, Qxua, Qxua, Qxua, Qxua, Qxua, Xu, Xu
Xu, Xu, Qxua, Qxua, Qxua, Cud^Kov, Cud, Xoa, Xoa, Qxua, Qxua, Qxua, Uh^Tf, Uu, Ur, Ss^Em, Ss, Sm^Qhu, Sm^Qhu, Rb^Qhh, Sm^Qhu, Ur^Edt, Ur^Edt, Uu, Ur, Qxua, Qxua, Qxua, Xoa, Qxua, Cud^Kov, Qxua, Qxua, Xu, Xu
Xu, Xu, Qxua, Qxua, Xoa, Cud, Isa, Xoa, Xoa, Xoa^Efs, Ur^Edt, Ur^Edt, Uu, Uh, Uu, Uu^Tf, Qxua, Rb^Qhh, Rb^Qhh, Rb^Qhh, Ss^Em, Uh^Edt, Uh^Tf, Uu^Tf, Uu^Edt, Uu^Edt, Uu^Edt, Xoa^Efs, Xoa, Cud, Cud, Qxua, Qxua, Qxua, Xu
Xu, Xu, Qxua, Qxua, Qxua, Xoa, Xoa, Isa^Pw/, Uu^Edt, Ur, Uh, Uu^Edt, Qxua, Qxua, Qxua, Qxua, Qxua^Es, Qxua, Qxua, Ss, Qxua, Qxua, Qxua, Qxua, Qxua, Uh^Edt, Ur, Isa^Edt, Isa, Isa^Pw\, Xoa, Xoa, Qxua, Qxua, Xu
Xu, Xu, Xu, Qxua, Qxua^Es, Qxua, Qxua, Uu^Edt, Uu^Edt, Uh^Tf, Qxua, Qxua, Qxua, Qxua, Qxua, Qxua, Qxua^Es, Qxua, Qxua^Xo, Qxua, Qxua, Qxua^Es, Qxua^Es, Qxua, Qxua, Uh^Tf, Uu^Tf, Isa, Qxua, Qxua, Qxua, Qxua, Qxua, Qxua, Xu
Xu, Xu, Xu, Qxua, Qxua^Es, Qxua, Qxua, Qxua, Ur, Uu, Qxua, Qxua^Es, Qxua^Es, Qxua, Qxua, Qxua^Es, Qxua^Xo, Qxua^Xo, Cud^Eb, Qxua^Xo, Qxua^Xo, Qxua, Qxua, Qxua^Es, Qxua, Uu, Ur^Edt, Ur^Edt, Qxua, Qxua, Qxua, Qxua, Xu, Xu, Xu
Xu, Xu, Xu, Qxua, Qxua, Qxua^Es, Qxua, Uu^Tf, Uh^Edt, Ur^Edt, Uu^Edt, Qxua, Qxua, Qxua^Es, Qxua, Qxua^Xo, Cud^Eb, Cud, Isa^Edt, Cud, Cud^Eb, Qxua^Xo, Qxua^Es, Qxua^Es, Qxua, Qxua, Uh, Ur^Edt, Qxua, Qxua, Xu, Xu, Xu, Xu, Xu
Xu, Xu, Xu, Xu, Xu, Qxua, Qxua^Es, Qxua, Qxua, Ur^Edt, Ur^Qhu, Uh, Qxua, Qxua^Es, Qxua^Es, Qxua^Xo, Cud, Isa^Edt, Isa^Edt, Isa^Edt, Cud, Qxua^Xo, Qxua, Qxua, Qxua, Qxua, Uh^Tf, Uu, Qxua, Xu, Xu, Xu, Xu, Xu, Xu
Xu, Xu, Xu, Xu, Qxua, Qxua, Qxua^Es, Qxua, Qxua, Qxua, Uu^Tf, Ur^Qhu, Ur^Qhu, Qxua, Qxua, Qxua^Xo, Cud^Eb, Isa^Edt, Isa^Edt, Isa^Edt, Cud^Eb, Qxua^Xo, Qxua^Es, Qxua, Qxua, Uu^Tf, Ur^Edt, Ur^Edt, Qxua, Xu, Xu, Xu, Xu, Xu, Xu
Xu, Xu, Xu, Xu, Qxua, Qxua, Qxua, Qxua^Es, Qxua^Es, Qxua, Qxua, Uh^Tf, Uh, Uu, Qxua, Qxua^Xo, Qxua^Xo, Cud, Cud^Eb, Cud, Qxua^Xo, Qxua^Xo, Qxua^Es, Qxua, Uh^Qhu, Ur^Qhu, Uh, Qxua, Qxua^Es, Qxua, Xu, Xu, Xu, Xu, Xu
Xu, Xu, Xu, Xu, Xu, Qxua, Qxua, Qxua, Qxua, Qxua, Qxua^Es, Qxua, Uu, Ur, Qxua, Qxua^Es, Qxua, Qxua^Xo, Qxua^Xo, Qxua^Xo, Qxua, Qxua, Qxua^Es, Qxua, Ur^Qhu, Uh^Tf, Qxua, Qxua, Qxua^Es, Qxua, Xu, Xu, Xu, Xu, Xoa
Xu, Xu, Xu, Xu, Xu, Xu, Xu, Xu, Xu, Qxua, Qxua, Qxua, Cud, Uu, Qxua, Qxua^Es, Qxua^Es, Qxua, Qxua, Qxua^Es, Qxua^Es, Qxua^Es, Qxua, Ur^Qhu, Uh^Tf, Uu, Qxua, Qxua^Es, Qxua, Qxua, Xu, Xu, Xoa, Xoa, Isa
Xoa, Xu, Xu, Xu, Xu, Xu, Xoa, Xoa, Uu^Tf, Qxua, Qxua, Cud, Kud, Cud, Isa^Edt, Qxua, Qxua, Qxua^Es, Qxua^Es, Qxua, Qxua, Qxua, Qxua, Uh, Uu, Uu, Isa^Edt, Qxua, Qxua, Xu, Xoa, Xoa, Uu, Isa, Isa
Isa, Xoa, Xoa, Xu, Xoa, Xoa, Uu^Pw\o, Isa, Isa^Edt, Uh^Edt, Isa^Edt, Cud, Uu, Isa^Edt, Isa^Edt, Isa^Edt, Uu^Tf, Qxua, Qxua, Qxua, Qxua, Qxua, Isa^Edt, Isa^Edt, Uu^Tf, Uh^Edt, Isa^Edt, Isa^Edt, Isa, Xoa, Isa^Pw\, Uu, Uu, Isa, Xoa
Isa, Isa, Isa, Xoa, Isa^Edt, Isa^Edt, Uh, Isa^Pw\o, Xoa, Uu^Edt, Isa, Isa, Uh^Tf, Uh, Cud, Uu, Uh, Isa, Isa^Edt, Qxua, Uh, Isa, Isa, Isa^Edt, Uu, Uh^Tf, Uu, Isa, Uh, Uu, Isa, Isa^Pw\, Xoa, Xoa, Xu
Xoa, 2 Isa, Uu^Tf, 1 Uu, Uh^Edt, Uu^Edt, Xoa, Xoa, Xu, Xu, Qxua, Isa, Cud, Kud, Cud, Ur, Ur, Isa, Isa^Edt, Isa^Edt, Uu^Tf, Uh^Tf, Qxua, Qxua, Qxua, Ur^Qhu, Ur^Qhu, Qxua, Qxua, Isa, Xoa, Xoa, Xu, Xu, Xu
Xu, Xoa, Xoa, Uh^Tf, Xoa, Xoa, Xu, Xu, Qxua, Qxua, Qxua^Es, Qxua, Qxua, Cud, Uu^Edt, Ur, Qxua, Qxua, Qxua, Uu^Edt, Qxua, Qxua, Qxua^Es, Qxua^Es, Qxua, Ur^Qhu, Uu^Edt, Qxua, Qxua, Qxua, Xu, Xu, Xu, Xu, Xu
Xu, Xu, Xu, Xoa, Xu, Xu, Xu, Xu, Qxua, Qxua^Es, Qxua^Es, Qxua, Uu^Tf, Uh^Edt, Ur^Edt, Ur^Edt, Qxua, Qxua, Qxua^Es, Qxua, Qxua, Qxua, Qxua^Es, Qxua, Uu^Tf, Uu^Edt, Ur^Edt, Xoa, Qxua, Qxua, Qxua, Xu, Xu, Xu, Xu
Xu, Xu, Xu, Xu, Qxua, Qxua, Qxua, Qxua, Qxua, Qxua, Qxua, Qxua, Ur, Ur, Xu, Qxua, Qxua, Qxua^Es, Qxua, Qxua, Xu, Qxua, Qxua, Qxua, Uu^Tf, Ur^Edt, Uh, Xoa^Efs, Xoa, Qxua, Qxua, Qxua, Xu, Xu, Xu
Xu, Xu, Xu, Xu, Qxua, Qxua, Xoa, Xoa^Efs, Uu^Tf, Uh, Uh^Edt, Uu, Uu^Tf, Uu^Tf, Xu, Xu, Xu, Qxua, Xu, Xu, Xot^Efs, Xu, Xu, Xu, Xot, Uu, Ur, Uh^Tf, Uu, Cud, Cud^Kov, Qxua, Qxua, Xu, Xu
Xu, Xu, Xu, Qxua, Qxua, Qxua, Cud, Ur, Ur, Ur^Edt, Uu^Edt, Ur^Edt, Xot, Xot^Efs, Xot, Xot^Efs, Xot, Xu, Xot^Efs, Xot, Uu, Xot, Xot, Xot^Efs, Ur^Edt, Uu^Edb, Ur, Uu, Xoa, Cud, Qxua, Qxua, Qxua, Xu, Xu
Xu, Xu, Xu, Qxua, Qxua, Cud^Kov, Cud, Uu, Xoa, Xoa, Uu^Tf, Ur, Uu^Edb, Uh, Uh^Tf, Uu, Uu^Tf, Xot, Ur^Edb, Uh^Edb, Uh^Tf, Uu^Tf, Ur^Edb, Uh^Edb, Ur^Edt, Ur^Edt, Xoa, Xoa, Xoa, Qxua, Qxua, Qxua, Xu, Xu, Xu
Xu, Xu, Xu, Qxua, Qxua, Qxua, Qxua, Xoa, Qxua, Qxua, Qxua, Uu^Edb, Ur^Edb, Uu^Tf, Ur, Ur^Edb, Ur, Uh^Tf, Ur^Edb, Ur^Edb, Xu, Uu, Xu, Ur^Edb, Uu^Tf, Uh, Xoa, Xoa, Xoa, Qxua, Qxua, Qxua, Xu, Xu, Xu
Xu, Xu, Xu, Xu, Xu, Qxua, Xu, Xoa, Xoa, Qxua, Xu, Xu, Xu, Xu, Xu, Xu, Xu, Ur, Xu, Xu, Xu, Xu, Xu, Xu, Xu, Xu, Xu, Xu, Xu, Xu, Xu, Xu, Xu, Xu, Xu
Xu, Xu, Xu, Xu, Xu, Xu, Xu, Xu, Xu, Xu, Xu, Xu, Xu, Xu, Xu, Xu, Xu, Xu, Xu, Xu, Xu, Xu, Xu, Xu, Xu, Xu, Xu, Xu, Xu, Xu, Xu, Xu, Xu, Xu, Xu
Xu, Xu, Xu, Xu, Xu, Xu, Xu, Xu, Xu, Xu, Xu, Xu, Xu, Xu, Xu, Xu, Xu, Xu, Xu, Xu, Xu, Xu, Xu, Xu, Xu, Xu, Xu, Xu, Xu, Xu, Xu, Xu, Xu, Xu, Xu
