Xu, Xu, Xu, Xu, Xu, Xu, Xu, Xu, Qxu, Qxu, Qxu, Qxu, Qxu, Qxu, Qxu, Qxu, Qxu, Qxu, Qxu, Qxu, Qxu, Qxu, Qxu, Xu, Xu, Xu, Xu, Xu, Xu, Xu, Xu, Xu, Xu, Xu, Xu
Xu, Xu, Xu, Xu, Qxu, Qxu, Qxu, Qxu, Qxu, Qxu, Qxu, Qxu, Qxu, Qxu, Qxu, Qxu, Qxu, Qxu, Qxu, Qxu, Qxu, Qxu, Qxu, Qxu, Qxu, Xu, Xu, Xu, Xu, Xu, Xu, Xu, Xu, Xu, Xoa
Xu, Xu, Qxu, Qxu, Qxu, Qxu, Qxu, Qxu, Qxu, Qxu, Qxu, Qxu, Qxu, Qxu, Qxu, Qxu, Qxu, Qxu, Qxu, Qxu, Qxu, Qxu, Qxu, Qxu, Qxu, Xu, Xu, Xu, Xu, Xu, Xu, Xu, Xoa, Xoa, Xoa
Xu, Xu, Qxu, Qxu, Qxu, Qxu, Qxu, Qxu, Qxu, Qxu, Uu^QcnZ, Qxu, Qxu, Qxu, Qxu, Qxu, Qxu, Qxu, Qxu, Qxu, Qxu, Qxu, Qxu, Qxu, Qxu, Qxu, Xu, Xu, Xu, Xu, Xoa, Xoa, Xoa, Xoa, Uu
Xu, Xu, Qxu, Qxu, Qxu, Qxu, Uu^QcnZ, Uu^QcnZ, Uu^QcnZ, Uu^QcnZ, Re, Uu^QcnZ, Uu^QcnZ, Qxu, Qxu, Qxu, Qxu, Qxu, Qxu, Qxu, Qxu, Qxu, Qxu, Qxu, Qxu, Qxu, Xu, Xu, Xoa, Xoa, Xoa, Xoa, Isa, Uu, Isa
Xu, Xu, Xu, Qxu, Uu^QcnZ, Uu^QcnZ, Re, Re, Re, Re, Re^Ii, Re, Re, Uu^QcnZ, Uu^QcnZ, Qxu, Qxu, Qxu, Qxu, Qxu, Qxu, Qxu, Qxu, Qxu, Uu^QcnZ, Uu^QcnZ, Uu, Xoa, Xoa, Xoa, Isa, Isa, Uu, Isa, Xoa
Xu, Xu, Xu, Xu, Re, Re, Re^Ii, Re^Ii, Re^Ii, Re^Ii, Re, Re^Ii, Re^Ii, Re, Uu^QcnZ, Qxu, Qxu, Qxu, Qxu, Qxu, Qxu, Qxu, Qxu, Qxu, Uu^QcnZ, Uu, Ur, Ur, Uu, Uu, Isa, Uu, Xoa, Xoa, Xoa
Xu, Xu, Re, Re, Re^Ii, Re^Ii, Re, Re, Uu^QcsZ, Uu^QcsZ, Uu^QcsZ, Re, Re, Re^Ii, Re, Uu^QcnZ, Uu^QcnZ, Qxu, Uu^QcnZ, Qxu, Qxu, Qxu, Uu^QcnZ, Uu^QcnZ, Uu, Uu, Ur, Ur, Ur, Isa, Ur, Xoa, Xoa, Xoa, Xoa
Xu, Xu, Re, Re^Ii, Re, Re, Xu, Uu^QcsZ, Qxu, Qxu, Qxu, Uu^QcsZ, Uu^QcsZ, Re^Ii, Re^Ii, Re, Re, Uu^QcnZ, Re, Uu^QcnZ, Uu^QcnZ, Uu^QcnZ, Re, Re, Uu, Ur, Ur, Ur, Ur, Ur, Ur, Uu, Xu, Xoa, Xoa
Xu, Xu, Xu, Re^Ii, Re, Xu, Xu, Xu, Qxu, Qxu, Qxu, Qxu, Uu^QcsZ, Re, Re, Re^Ii, Re^Ii, Re^Ii, Re^Ii, Re, Re, Re, Re^Ii, Re^Ii, Re, Uu, Uu, Ur, Uu, Ur, Uu, Uu, Xu, Xu, Xu
Xu, Xu, Xu, Re^Ii, Re, Xu, Xu, Xu, Xu, Qxu, Qxu, Qxu, Qxu, Uu^QcsZ, Uu^QcsZ, Re, Uu^QcsZ, Re, Re, Re^Ii, Re^Ii, Re^Ii, Uu^QcsZ, Re, Uu^QcsZ, Uu^QcsZ, Uu^QcsZ, Uu, Uu^QcsZ, Uu, Uu^QcsZ, Uu^QcsZ, Xu, Xu, Xu
Xu, Xu, Re, Re^Ii, Re, Xu, Xu, Xu, Xu, Qxu, Qxu, Qxu, Qxu, Qxu, Qxu, Uu^QcsZ, Qxu, Uu^QcsZ, Uu^QcsZ, Re, Uu^QcsZ, Uu^QcsZ, Qxu, Uu^QcsZ, Qxu, Qxu, Qxu, Uu^QcsZ, Qxu, Uu^QcsZ, Qxu, Qxu, Xu, Xu, Xu
Xu, Xu, Re, Re^Ii, Re, Xu, Xu, Xu, Xu, Xu, Qxu, Qxu, Qxu, Qxu, Qxu, Qxu, Qxu, Qxu, Qxu, Uu^QcsZ, Qxu, Qxu, Qxu, Qxu, Qxu, Qxu, Qxu, Qxu, Qxu, Qxu, Qxu, Qxu, Qxu, Xu, Xu
Xu, Xu, Re, Re^Ii, Re, Xu, Xu, Xu, Xu, Xu, Uu^QcnZ, Uu^QcnZ, Uu^QcnZ, Qxu, Qxu, Qxu, Qxu, Qxu, Qxu, Qxu, Qxu, Qxu, Qxu, Qxu, Qxu, Qxu, Qxu, Qxu, Qxu, Qxu, Qxu, Qxu, Qxu, Xu, Xu
Xu, Xu, Re, Re^Ii, Re^Ii, Re, Re, Xu, Xu, Xu, Re, Re, Re^Ii, Uu^QcnZ, Uu^QcnZ, Qxu, Uu^QcnZ, Uu^QcnZ, Uu^QcnZ, Qxu, Qxu, Qxu, Uu^QcnZ, Qxu, Qxu, Qxu, Qxu, Qxu, Qxu, Qxu, Qxu, Qxu, Qxu, Qxu, Xu
Xu, Xu, Xu, Re, Re, Re^Ii, Re^Ii, Re, Re, Re, Re^Ii, Re^Ii, Re, Re^Ii, Re^Ii, Uu^QcnZ, Re, Re, Re, Uu^QcnZ, Uu^QcnZ, Uu^QcnZ, Re, Uu^QcnZ, Uu^QcnZ, Qxu, Qxu, Qxu, Qxu, Qxu, Qxu, Qxu, Qxu, Qxu, Qxu
Xu, Xu, Xu, Xu, Xu, Re, Re, Re^Ii, Re^Ii, Re^Ii, Uu^QcsZ, Uu^QcsZ, Uu^QcsZ, Re, Re, Re^Ii, Re^Ii, Re^Ii, Re^Ii, Re, Re, Re, Re^Ii, Re^Ii, Re^Ii, Uu^QcnZ, Uu^QcnZ, Qxu, Qxu, Qxu, Qxu, Qxu, Qxu, Qxu, Qxu
Xu, Xu, Xu, Xu, Xu, Uu^QcsZ, Uu^QcsZ, Re, Uu^QcsZ, Uu^QcsZ, Qxu, Qxu, Qxu, Uu^QcsZ, Uu^QcsZ, Re, Uu^QcsZ, Uu^QcsZ, Uu^QcsZ, Re^Ii, Re^Ii, Re^Ii, Re, Re, Re, Re^Ii, Re^Ii, Uu^QcnZ, Uu^QcnZ, Qxu, Qxu, Qxu, Qxu, Qxu, Qxu
Xu, Xu, Xu, Xu, Qxu, Qxu, Qxu, Uu^QcsZ, Qxu, Qxu, Qxu, Qxu, Qxu, Qxu, Qxu, Uu^QcsZ, Qxu, Qxu, Qxu, Uu^QcsZ, Uu^QcsZ, Re, Uu^QcsZ, Uu^QcsZ, Uu^QcsZ, Re, Re^Ii, Re, Re, Uu^QcnZ, Qxu, Qxu, Xu, Xu, Xu
Xu, Xu, Xu, Qxu, Qxu, Qxu, Qxu, Qxu, Qxu, Qxu, Qxu, Qxu, Qxu, Qxu, Qxu, Qxu, Qxu, Qxu, Qxu, Qxu, Qxu, Uu^QcsZ, Qxu, Qxu, Qxu, Uu^QcsZ, Uu^QcsZ, Re^Ii, Re^Ii, Uu^QcnZ, Uu^QcnZ, Qxu, Xu, Xu, Xu
Xu, Xu, Xu, Qxu, Qxu, Qxu, Qxu, Qxu, Qxu, Qxu, Qxu, Qxu, Qxu, Qxu, Qxu, Qxu, Qxu, Qxu, Qxu, Qxu, Qxu, Qxu, Qxu, Qxu, Qxu, Qxu, Xu, Re, Re, Re^Ii, Re, Xu, Xu, Xu, Xu
Xu, Xu, Qxu, Qxu, Qxu, Qxu, Qxu, Qxu, Qxu, Qxu, Qxu, Qxu, Qxu, Qxu, Qxu, Qxu, Qxu, Qxu, Qxu, Qxu, Qxu, Qxu, Qxu, Qxu, Qxu, Qxu, Xu, Xu, Re, Re^Ii, Re, Xu, Xu, Xu, Xu
Xu, Xu, Qxu, Qxu, Qxu, Qxu, Qxu, Qxu, Qxu, Qxu, Qxu, Qxu, Qxu, Qxu, Qxu, Qxu, Qxu, Qxu, Qxu, Qxu, Qxu, Qxu, Qxu, Qxu, Qxu, Xu, Xu, Xu, Re, Re^Ii, Re^Ii, Re, Xu, Xu, Xu
Xu, Qxu, Qxu, Qxu, Qxu, Qxu, Qxu, Qxu, Qxu, Qxu, Qxu, Qxu, Qxu, Qxu, Qxu, Qxu, Qxu, Qxu, Qxu, Qxu, Qxu, Qxu, Qxu, Qxu, Qxu, Xu, Xu, Xu, Xu, Re, Re^Ii, Re, Xu, Xu, Xu
Qxu, Qxu, Qxu, Qxu, Qxu, Qxu, Qxu, Qxu, Qxu, Qxu, Qxu, Qxu, Qxu, Qxu, Qxu, Qxu, Qxu, Qxu, Qxu, Qxu, Qxu, Qxu, Qxu, Qxu, Xu, Xu, Xu, Xu, Xu, Re, Re^Ii, Re, Xu, Xu, Xu
Qxu, Qxu, Qxu, Qxu, Qxu, Qxu, Qxu, Qxu, Qxu, Qxu, Qxu, Qxu, Qxu, Qxu, Qxu, Qxu, Qxu, Qxu, Qxu, Qxu, Qxu, Qxu, Qxu, Qxu, Xu, Xu, Xu, Xu, Xu, Re, Re^Ii, Re, Xu, Xu, Xu
Xu, Qxu, Qxu, Qxu, Qxu, Qxu, Qxu, Qxu, Qxu, Qxu, Qxu, Qxu, Qxu, Qxu, Qxu, Qxu, Qxu, Qxu, Uu^QcnZ, Qxu, Qxu, Qxu, Uu^QcnZ, Uu^QcnZ, Uu^QcnZ, Xu, Xu, Xu, Xu, Re, Re^Ii, Re, Xu, Xu, Xu
Xu, Xu, Qxu, Qxu, Qxu, Qxu, Qxu, Qxu, Qxu, Qxu, Qxu, Qxu, Qxu, Qxu, Uu^QcnZ, Qxu, Uu^QcnZ, Uu^QcnZ, Re, Uu^QcnZ, Uu^QcnZ, Uu^QcnZ, Re^Ii, Re, Re, Xu, Xu, Xu, Re, Re, Re^Ii, Re, Xu, Xu, Xu
Xu, Xu, Xu, Qxu, Qxu, Qxu, Qxu, Qxu, Qxu, Qxu, Qxu, Qxu, Uu^QcnZ, Uu^QcnZ, Re, Uu^QcnZ, Re, Re, Re^Ii, Re, Re^Ii, Re^Ii, Re, Re^Ii, Re^Ii, Re, Re, Re, Re^Ii, Re^Ii, Re, Re, Xu, Xu, Xu
Xu, Xu, Xu, Xu, Uu^QcnZ, Uu^QcnZ, Uu^QcnZ, Qxu, Qxu, Qxu, Uu^QcnZ, Uu^QcnZ, Re, Re, Re^Ii, Re, Re^Ii, Re^Ii, Re, Re^Ii, Re, Re, Uu^QcsZ, Re, Re, Re^Ii, Re^Ii, Re^Ii, Uu^QcsZ, Re, Xu, Xu, Xu, Xu, Xu
Xu, Xu, Xu, Xu, Re, Re, Re^Ii, Uu^QcnZ, Uu^QcnZ, Uu^QcnZ, Re, Re, Re^Ii, Re^Ii, Re, Re^Ii, Uu^QcsZ, Uu^QcsZ, Uu^QcsZ, Re, Uu^QcsZ, Uu^QcsZ, Qxu, Uu^QcsZ, Uu^QcsZ, Re, Uu^QcsZ, Uu^QcsZ, Qxu, Xu, Xu, Xu, Xu, Xu, Xu
Xu, Xu, Re, Re, Re^Ii, Re^Ii, Re, Re^Ii, Re^Ii, Re, Re^Ii, Re^Ii, Re, Re, Uu^QcsZ, Uu^QcsZ, Qxu, Qxu, Qxu, Uu^QcsZ, Qxu, Qxu, Qxu, Qxu, Qxu, Uu^QcsZ, Qxu, Qxu, Qxu, Qxu, Qxu, Xu, Qxu, Xu, Qxu
Xu, Xu, Re, Re^Ii, Re, Re, Xu, Re, Re, Re^Ii, Uu^QcsZ, Uu^QcsZ, Uu^QcsZ, Uu^QcsZ, Qxu, Qxu, Qxu, Qxu, Qxu, Qxu, Qxu, Qxu, Qxu, Qxu, Qxu, Qxu, Qxu, Qxu, Qxu, Qxu, Qxu, Qxu, Qxu, Qxu, Qxu
Xu, Xu, Re, Re^Ii, Re, Xu, Xu, Xu, Uu^QcsZ, Uu^QcsZ, Qxu, Qxu, Qxu, Qxu, Qxu, Qxu, Qxu, Qxu, Qxu, Qxu, Qxu, Qxu, Qxu, Qxu, Qxu, Qxu, Qxu, Qxu, Qxu, Qxu, Qxu, Qxu, Qxu, Qxu, Qxu
Xu, Xu, Re, Re^Ii, Re, Xu, Xu, Xu, Xu, Qxu, Qxu, Qxu, Qxu, Qxu, Qxu, Qxu, Qxu, Qxu, Qxu, Qxu, Qxu, Qxu, Qxu, Qxu, Qxu, Qxu, Qxu, Qxu, Qxu, Qxu, Qxu, Qxu, Qxu, Qxu, Qxu
Xu, Xu, Re, Re^Ii, Re, Xu, Xu, Xu, Xu, Qxu, Qxu, Qxu, Qxu, Qxu, Qxu, Qxu, Qxu, Qxu, Qxu, Qxu, Qxu, Qxu, Qxu, Qxu, Qxu, Qxu, Qxu, Qxu, Qxu, Qxu, Qxu, Qxu, Qxu, Qxu, Qxu
Xu, Xu, Re, Re^Ii, Re, Xu, Xu, Xu, Xu, Qxu, Qxu, Qxu, Qxu, Qxu, Uu^QcnZ, Uu^QcnZ, Uu^QcnZ, Qxu, Qxu, Qxu, Qxu, Qxu, Qxu, Qxu, Qxu, Qxu, Qxu, Qxu, Qxu, Qxu, Qxu, Qxu, Qxu, Qxu, Qxu
Xu, Xu, Re, Re^Ii, Re^Ii, Re, Re, Xu, Uu^QcnZ, Qxu, Qxu, Qxu, Uu^QcnZ, Uu^QcnZ, Re, Re, Re, Uu^QcnZ, Uu^QcnZ, Qxu, Uu^QcnZ, Qxu, Qxu, Qxu, Qxu, Qxu, Qxu, Qxu, Qxu, Qxu, Qxu, Qxu, Qxu, Qxu, Qxu
Xu, Xu, Xu, Re, Re, Re^Ii, Re^Ii, Re, Re, Uu^QcnZ, Uu^QcnZ, Uu^QcnZ, Re^Ii, Re, Re^Ii, Re^Ii, Re^Ii, Re, Re^Ii, Uu^QcnZ, Re, Uu^QcnZ, Uu^QcnZ, Uu^QcnZ, Uu^QcnZ, Qxu, Uu^QcnZ, Qxu, Qxu, Qxu, Qxu, Qxu, Xu, Qxu, Xu
Xu, Xu, Xu, Xu, Uu^QcnZ, Uu^QcnZ, Uu^QcnZ, Re^Ii, Re^Ii, Re, Re^Ii, Re^Ii, Re, Re^Ii, Uu^QcsZ, Uu^QcsZ, Uu^QcsZ, Re^Ii, Re, Re^Ii, Re^Ii, Re, Re, Re, Re^Ii, Uu^QcnZ, Re, Uu^QcnZ, Uu^QcnZ, Qxu, Qxu, Xu, Xu, Xu, Xu
Xu, Xu, Xu, Xu, Qxu, Qxu, Qxu, Uu^QcnZ, Uu^QcnZ, Re^Ii, Re, Re, Uu^QcsZ, Uu^QcsZ, Qxu, Qxu, Qxu, Uu^QcsZ, Uu^QcsZ, Re, Uu^QcsZ, Re^Ii, Re^Ii, Re^Ii, Re, Re^Ii, Re^Ii, Re, Re, Uu^QcnZ, Uu^QcnZ, Xu, Xu, Xu, Xu
Xu, Xu, Qxu, Qxu, Qxu, Qxu, Qxu, Qxu, Uu^QcnZ, Re^Ii, Re, Uu^QcsZ, Qxu, Qxu, Qxu, Qxu, Qxu, Qxu, Qxu, Uu^QcsZ, Qxu, Uu^QcsZ, Uu^QcsZ, Uu^QcsZ, Uu^QcsZ, Re, Uu^QcsZ, Re^Ii, Re^Ii, Re, Re, Uu^QcnZ, Xu, Xu, Xu
Xu, Xu, Qxu, Qxu, Qxu, Qxu, Qxu, Qxu, Uu^QcnZ, Re^Ii, Re, Uu^QcsZ, Qxu, Qxu, Qxu, Qxu, Qxu, Qxu, Qxu, Qxu, Qxu, Qxu, Qxu, Qxu, Qxu, Uu^QcsZ, Qxu, Uu^QcsZ, Uu^QcsZ, Re^Ii, Re, Uu^QcnZ, Xu, Xu, Xu
Xu, Xu, Xu, Qxu, Qxu, Qxu, Uu^QcnZ, Uu^QcnZ, Re^Ii, Re^Ii, Re, Uu^QcsZ, Qxu, Qxu, Qxu, Qxu, Xu, Xu, Qxu, Qxu, Qxu, Qxu, Xu, Qxu, Qxu, Qxu, Qxu, Qxu, Qxu, Re^Ii, Qxu, Uu^QcnZ, Xu, Xu, Xu
Xu, Xu, Xu, Qxu, Qxu, Uu^QcnZ, Re, Re^Ii, Re, Re, Uu^QcsZ, Uu^QcsZ, Xu, Qxu, Qxu, Qxu, Xu, Xu, Xu, Qxu, Xu, Xu, Xu, Xu, Xu, Xu, Xu, Qxu, Qxu, Qxu, Qxu, Qxu, Xu, Xu, Xu
Xu, Xu, Xu, Qxu, Qxu, Uu^QcnZ, Re, Re^Ii, Re, Uu^QcsZ, Qxu, Xu, Xu, Xu, Xu, Qxu, Xu, Xu, Xu, Xu, Xu, Xu, Xu, Xu, Xu, Xu, Qxu, Qxu, Qxu, Qxu, Qxu, Qxu, Qxu, Xu, Xu
Xu, Xu, Xu, Xu, Qxu, Uu^QcnZ, Uu^QcnZ, Re^Ii, Qxu, Qxu, Qxu, Qxu, Qxu, Xu, Xu, Xu, Xu, Xu, Xu, Xu, Xu, Xu, Xu, Xu, Qxu, Qxu, Qxu, Qxu, Qxu, Qxu, Qxu, Qxu, Qxu, Xu, Xu
Xu, Xu, Xu, Xu, Xu, Qxu, Qxu, Qxu, Qxu, Qxu, Qxu, Qxu, Qxu, Qxu, Qxu, Xu, Xu, Xu, Xu, Xu, Xu, Xu, Xu, Xu, Qxu, Qxu, Qxu, Qxu, Qxu, Qxu, Qxu, Qxu, Xu, Xu, Xu
Xu, Xu, Xu, Xu, Xu, Qxu, Qxu, Qxu, Qxu, Qxu, Qxu, Qxu, Qxu, Qxu, Qxu, Xu, Xu, Xu, Xu, Xu, Xu, Xu, Xu, Qxu, Qxu, Qxu, Qxu, Qxu, Qxu, Qxu, Qxu, Qxu, Xu, Xu, Xu
Xu, Xu, Xu, Xu, Xu, Qxu, Qxu, Qxu, Qxu, Qxu, Qxu, Qxu, Qxu, Qxu, Qxu, Qxu, Xu, Xu, Xu, Xu, Xu, Xu, Xu, Qxu, Qxu, Qxu, Qxu, Qxu, Qxu, Qxu, Qxu, Qxu, Xu, Xu, Xu
Xu, Xu, Xu, Xu, Xu, Qxu, Qxu, Qxu, Qxu, Qxu, Qxu, Qxu, Qxu, Qxu, Qxu, Qxu, Xu, Xu, Xu, Xu, Xu, Xu, Xu, Qxu, Qxu, Qxu, Qxu, Qxu, Qxu, Qxu, Qxu, Qxu, Xu, Xu, Xu
Xu, Xu, Xu, Xu, Xu, Qxu, Qxu, Qxu, Qxu, Qxu, Qxu, Qxu, Qxu, Qxu, Qxu, Qxu, Qxu, Xu, Xu, Xu, Qxu, Xu, Qxu, Qxu, Qxu, Qxu, Qxu, Qxu, Qxu, Qxu, Qxu, Xu, Xu, Xu, Xu
Xu, Xu, Xu, Xu, Xu, Xu, Xu, Qxu, Qxu, Qxu, Qxu, Qxu, Qxu, Qxu, Qxu, Qxu, Qxu, Qxu, Qxu, Qxu, Qxu, Qxu, Qxu, Qxu, Qxu, Qxu, Qxu, Qxu, Qxu, Qxu, Xu, Xu, Xu, Xu, Xu
Xu, Xu, Xu, Xu, Xu, Xu, Xu, Xu, Xu, Xu, Xu, Qxu, Xu, Qxu, Qxu, Qxu, Qxu, Qxu, Qxu, Qxu, Qxu, Qxu, Qxu, Qxu, Qxu, Qxu, Qxu, Qxu, Xu, Xu, Xu, Xu, Xu, Xu, Xu
Xu, Xu, Xu, Xu, Xu, Xu, Xu, Xu, Xu, Xu, Xu, Xu, Xu, Xu, Xu, Qxu, Ur, Qxu, Qxu, Qxu, Ur, Qxu, Qxu, Qxu, Ur, Qxu, Xu, Xu, Xu, Xu, Xu, Xu, Xu, Xu, Xu
Xu, Xu, Xu, Xu, Xu, Xu, Xu, Xu, Xu, Xu, Xu, Xu, Xu, Xu, Xu, Ur, Ur, Ur, Ur, Ur, Ur, Ur, Ur, Ur, Ur, Ur, Xu, Xu, Xu, Xu, Xu, Xu, Xu, Xu, Xu
Xu, Xu, Xu, Xu, Xu, Xu, Xu, Xu, Xu, Xu, Xu, Xu, Xu, Xu, Xu, Ur, Ur, Ur, Ur, Ur, Ur, Ur, Ur, Ur, Ur, Ur, Xu, Xu, Xu, Xu, Xu, Xu, Xu, Xu, Xu
