Xu, Xu, Xu, Xu, Xu, Xu, Xu, Xu, Xu, Xu, Xu, Xu, Xu, Xu, Xu, Xu, Qxu, Qxu, Qxu, Qxu, Qxu, Qxu, Qxu, Xu, Xu, Xu, Xu, Xu, Xu, Xu, Xu, Xu, Xu, Xu, Xu
Xu, Xu, Xu, Xu, Xu, Xu, Rb^QcsZ, Xu, Xu, Xu, Qxu, Qxu, Qxu, Xu, Qxu, Qxu, Qxu, Qxu, Rb^QcnZ, Qxu, Qxu, Qxu, Qxu, Qxu, Xu, Xu, Xu, Xu, Xu, Xu, Xu, Xu, Xu, Xu, Xoa
Xu, Xu, Uu, Rb^QcsZ, Uu, Uu, Rb^QcsZ, Xu, Xu, Xu, Qxu, Qxu, Qxu, Qxu, Qxu, Qxu, Rb^QcnZ, Rb^QcnZ, Uu, Rb^QcsZ, Rb^QcnZ, Rb^QcnZ, Rb^QcsZ, Qxu, Qxu, Xu, Xu, Xu, Xu, Xu, Xu, Xu, Xoa, Xoa, Xoa
Xu, Xu, Uu, Rb^QcsZ, Uu, Rb^QcsZ, Xu, Xu, Xu, Xu, Rb^QcnZ, Qxu, Qxu, Qxu, Xu, Rb^QcnZ, Xu, Uu, Uu, Uu, Uu, Uu, Rb^QcsZ, Qxu, Qxu, Xu, Xu, Xu, Xu, Xu, Xoa, Xoa, Xoa^Efs, Xoa, Uu
Xu, Xu, Uu, Rb^QcsZ, Uu, Rb^QcsZ, Rb^QcsZ, Xu, Rb^QcnZ, Rb^QcnZ, Re, Rb^QcsZ, Rb^QcsZ, Xu, Xu, Xu, Rb, Rb^QcsZ, Rb^QcsZ, Uu, Uu, Uu, Xu, Qxu, Qxu, Qxu, Xu, Xu, Xoa, Xoa, Xoa^Efs, Xoa, 1 Isa, Uu, Isa
Xu, Xu, Xu, Uu, Uu, Uu, Re, Rb^QcnZ, Re, Re, Rb^Ii, Re, Re, Rb^QcsZ, Rb^QcsZ, Rb, Rb, Rb, Rb, Rb^QcsZ, Rb^QcsZ, Rb, Rb, Xu, Rb^QcnZ, Rb^QcnZ, Uu, Xoa^Efs, Xoa, Xoa, Isa, Isa, Uu, Isa, Xoa
Xu, Xu, Xu, Xu, Re, Re, Rb^Ii, Rb^Ii, Rb^Ii, Rb^Ii, Re, Rb^Ii, Rb^Ii, Re, Rb^QcsZ, Rb, Rb, Rb, Rb, Rb, Rb, Rb, Rb, Rb, Rb, Uu, Ur, Ur, Uu, Uu, Isa, Uu, Xoa, Xoa, Xoa
Xu, Xu, Re, Re, Rb^Ii, Rb^Ii, Re, Re, Rb^QcsZ, Rb^QcsZ, Rb^QcnZ, Re, Re, Rb^Ii, Re, Rb^QcsZ, Rb^QcsZ, Rb, Rb^QcnZ, Rb, Rb, Rb, Rb^QcnZ, Rb, Uu, Uu, Ur, Ur, Ur, Isa, Ur, Xoa^Efs, Xoa, Xoa, Xoa
Xu, Xu, Re, Rb^Ii, Re, Re, Xu, Rb^QcsZ, Qxu^Xo, Qxu, Qxu, Rb^QcnZ, Rb^QcnZ, Rb^Ii, Rb^Ii, Re, Re, Rb^QcnZ, Re, Rb^QcsZ, Rb^QcnZ, Rb^QcnZ, Re, Re, Uu, Ur, Ur, Ur, Ur, Ur, Ur, Uu, Xu, Xoa, Xoa
Xu, Xu, Xu, Rb^Ii, Re, Xu, Xu, Xu, Uu, Qxu^Xo, Qxu^Xo, Qxu, Rb^QcnZ, Re, Re, Rb^Ii, Rb^Ii, Rb^Ii, Rb^Ii, Re, Re, Re, Rb^Ii, Rb^Ii, Re, Uu, Uu, Ur, Uu, Ur, Uu, Uu, Xu, Xu, Xu
Xu, Xu, Xu, Rb^Ii, Re, Xu, Xu, Xu, Xu, Uu, Qxu^Xo, Qxu, Qxu, Rb^QcnZ, Rb^QcnZ, Re, Rb^QcsZ, Re, Re, Rb^Ii, Rb^Ii, Rb^Ii, Rb^QcsZ, Re, Rb^QcsZ, Rb^QcsZ, Rb^QcnZ, Uu, Rb^QcsZ, Uu, Rb^QcsZ, Rb^QcsZ, Xu, Xu, Xu
Xu, Xu, Re, Rb^Ii, Re, Xu, Xu, Xu, Xu, Uu, Qxu, Qxu^Xo, Qxu^Xo, Qxu, Qxu, Rb^QcsZ, Qxu, Rb^QcnZ, Rb^QcnZ, Re, Rb^QcsZ, Rb^QcsZ, Qxu, Rb^QcsZ, Uu, Uh, Uu, Rb^QcsZ, Uh, Rb^QcsZ, Qxu, Qxu, Xu, Xu, Xu
Xu, Xu, Re, Rb^Ii, Re, Xu, Xu, Xu, Xu, Xu, Qxu, Qxu, Qxu, Qxu^Xo, Qxu^Xo, Qxu, Qxu^Xo, Qxu^Xo, Qxu^Xo, Rb^QcsZ, Qxu, Qxu, Qxu^Xo, Qxu, Qxu, Uu, Xu, Uu, Uu, Uu, Qxu, Qxu, Qxu^Xo, Xu, Xu
Xu, Xu, Re, Rb^Ii, Re, Xu, Xu, Xu, Xu, Xu, Rb^QcnZ, Rb^QcnZ, Rb^QcsZ, Qxu, Qxu, Qxu^Xo, Qxu, Qxu, Qxu, Qxu^Xo, Qxu^Xo, Qxu^Xo, Qxu, Qxu^Xo, Qxu^Xo, Qxu^Xo, Xu, Xu, Xu, Qxu^Xo, Qxu^Xo, Qxu^Xo, Qxu, Xu, Xu
Xu, Xu, Re, Rb^Ii, Rb^Ii, Re, Re, Xu, Xu, Xu, Re, Re, Rb^Ii, Rb^QcsZ, Rb^QcsZ, Qxu, Rb^QcnZ, Rb^QcnZ, Rb^QcsZ, Qxu, Qxu, Qxu, Rb^QcnZ, Qxu, Qxu, Qxu, Re, Xu, Rb^QcsZ, Qxu, Qxu, Qxu, Qxu, Qxu, Xu
Xu, Xu, Xu, Re, Re, Rb^Ii, Rb^Ii, Re, Re, Re, Rb^Ii, Rb^Ii, Re, Rb^Ii, Rb^Ii, Rb^QcnZ, Re, Re, Re, Rb^QcsZ, Rb^QcnZ, Rb^QcnZ, Re, Rb^QcsZ, Rb^QcsZ, Re, Re, Re, Re, Rb^QcsZ, Rb^QcsZ, Qxu, Qxu, Qxu, Qxu
Xu, Xu, Xu, Xu, Xu, Re, Re, Rb^Ii, Rb^Ii, Rb^Ii, Rb^QcsZ, Rb^QcsZ, Re, Re, Re, Rb^Ii, Rb^Ii, Rb^Ii, Rb^Ii, Re, Re, Re, Rb^Ii, Rb^Ii, Rb^Ii, Rb^QcsZ, Rb^QcsZ, Re, Re, Re, Rb^QcsZ, Qxu, Qxu, Qxu, Qxu
Xu, Xu, Xu, Xu, Xu, Rb^QcnZ, Rb^QcnZ, Re, Rb^QcsZ, Rb^QcsZ, Re, Re, Re, Rb^QcnZ, Rb^QcnZ, Re, Rb^QcsZ, Rb^QcsZ, Rb^QcnZ, Rb^Ii, Rb^Ii, Rb^Ii, Re, Re, Re, Rb^Ii, Rb^Ii, Rb^QcsZ, Re, Re, Rb^QcsZ, Qxu, Qxu, Qxu, Qxu
Xu, Xu, Xu, Xu, Qxu, Qxu, Qxu, Rb^QcsZ, Qxu, Qxu, Re, Re, Qxu, Qxu, Qxu, Rb^QcsZ, Qxu, Qxu, Qxu, Rb^QcnZ, Rb^QcnZ, Re, Rb^QcsZ, Rb^QcsZ, Rb^QcnZ, Re, Rb^Ii, Re, Re, Re, Qxu, Qxu, Xu, Xu, Xu
Xu, Xu, Xu, Xu, Xu, Qxu, Qxu, Qxu, Qxu, Re, Re, Re, Xu, Qxu, Qxu, Qxu, Xu, Qxu, Qxu, Qxu, Qxu, Rb^QcsZ, Qxu, Qxu, Qxu, Rb^QcnZ, Rb^QcnZ, Rb^Ii, Rb^Ii, Rb^QcsZ, Rb^QcsZ, Qxu, Xu, Xu, Xu
Xu, Xu, Xu, Xu, Xu, Xu, Xu, Qxu, Re, Re, Re, Xu, Xu, Xu, Xu, Xu, Xu, Xu, Uu, Qxu, Qxu, Qxu, Qxu, Qxu, Uu, Qxu, Xu, Re, Re, Rb^Ii, Re, Xu, Xu, Xu, Xu
Xu, Xu, Qlf^Ii, Ql, Re, Xu, Xu, Re, Re, Re, Xu, Xu, Xu, Xu, Xu, Xu, Uu, Xu, Xu, Uu, Xu, Uu, Uu, Uu, Xu, Xu, Xu, Xu, Re, Rb^Ii, Re, Xu, Xu, Xu, Xu
Xu, Xu, Qlf^Ii, Qlf^Ii, Re, Xu, Xu, Xu, Xu, Xu, Xu, Xu, Uu, Uu, Uu, Uu, Sm, Uu, Xu, Xu, Xu, Xu, Xu, Xu, Xu, Xu, Xu, Xu, Re, Rb^Ii, Rb^Ii, Re, Xu, Xu, Xu
Xu, Xu, Xu, Ql, Ql, Re, Xu, Xu, Xu, Xu, Uu, Uu, Sm, Sm, Urb, Sm, Sm, Sm, Uu, Xu, Xu, Xu, Qxu, Xu, Qxu, Xu, Xu, Xu, Xu, Re, Rb^Ii, Re, Xu, Xu, Xu
Xu, Xu, Xu, Qlf, Ql, Re, Xu, Xu, Xu, Xu, Sm, Sm, Urb, Urb, Sm, Urb, Urb, Sm, Sm, Uu, Xu, Xu, Qxu, Qxu, Qxu, Qxu, Xu, Xu, Xu, Re, Rb^Ii, Re, Xu, Xu, Xu
Xu, Xu, Xu, Xu, Re, Ql, Xu, Xu, Xu, Uu, Sm, Sm, Urb, Sm, Sm, Sm, Urb, Sm, Sm, Uu, Uu, Qxu, Qxu, Qxu, Qxu, Qxu, Xu, Xu, Xu, Re, Rb^Ii, Re, Xu, Xu, Xu
Xu, Xu, Xu, Xu, Re, Ql, Qlf, Xu, Xu, Uu, Uu, Sm, Uu, Urb, Urb, Urb, Sm, Sm, Rb^QcnZ, Re, Re, Uu, Rb^QcnZ, Rb^QcnZ, Rb^QcsZ, Qxu, Xu, Xu, Xu, Re, Rb^Ii, Re, Xu, Xu, Xu
Xu, Xu, Xu, Re, Ql, Ql, Qlf, Xu, Xu, Xu, Xu, Uu, Sm, Sm, Rb^QcnZ, Uu, Rb^QcnZ, Rb^QcnZ, Re, Re, Re, Rb^QcnZ, Rb^Ii, Re, Re, Xu, Xu, Xu, Re, Re, Rb^Ii, Re, Xu, Xu, Xu
Xu, Xu, Xu, Re, Ql, Ql, Ql, Xu, Xu, Xu, Xu, Uu, Re, Rb^QcnZ, Re, Rb^QcnZ, Re, Re, Rb^Ii, Re, Rb^Ii, Rb^Ii, Re, Rb^Ii, Rb^Ii, Re, Re, Re, Rb^Ii, Rb^Ii, Re, Re, Xu, Xu, Xu
Xu, Xu, Xu, Xu, Rb^QcnZ, Rb^QcnZ, Rb^QcsZ, Xu, Xu, Xu, Rb^QcnZ, Re, Re, Re, Rb^Ii, Re, Rb^Ii, Rb^Ii, Re, Rb^Ii, Re, Re, Rb^QcsZ, Re, Re, Rb^Ii, Rb^Ii, Rb^Ii, Rb^QcsZ, Re, Xu, Xu, Xu, Xu, Xu
Xu, Xu, Xu, Xu, Re, Re, Rb^Ii, Rb^QcsZ, Rb^QcnZ, Rb^QcnZ, Re, Re, Rb^Ii, Rb^Ii, Re, Rb^Ii, Rb^QcsZ, Rb^QcsZ, Rb^QcnZ, Re, Rb^QcsZ, Rb^QcsZ, Qxu, Rb^QcnZ, Rb^QcnZ, Re, Rb^QcsZ, Rb^QcsZ, Qxu, Xu, Xu, Xu, Xu, Xu, Xu
Xu, Xu, Re, Re, Rb^Ii, Rb^Ii, Re, Rb^Ii, Rb^Ii, Re, Rb^Ii, Rb^Ii, Re, Re, Rb^QcsZ, Rb^QcsZ, Qxu, Qxu, Qxu, Rb^QcsZ, Qxu, Qxu, Qxu, Qxu, Qxu, Rb^QcsZ, Qxu, Qxu, Qxu, Qxu, Qxu, Xu, Qxu, Xu, Qxu
Xu, Xu, Re, Rb^Ii, Re, Re, Xu, Re, Re, Rb^Ii, Rb^QcsZ, Rb^QcsZ, Rb^QcsZ, Rb^QcsZ, Qxu, Qxu, Qxu, Qxu, Qxu, Qxu, Qxu, Qxu, Qxu, Qxu, Qxu, Qxu, Qxu, Qxu, Qxu, Qxu, Qxu, Qxu, Qxu, Qxu, Qxu
Xu, Xu, Re, Rb^Ii, Re, Xu, Xu, Xu, Rb^QcsZ, Rb^QcsZ, Qxu, Qxu, Qxu, Qxu, Qxu, Qxu, Qxu, Qxu, Qxu, Qxu, Qxu, Qxu, Qxu, Qxu, Qxu, Qxu, Qxu, Qxu, Qxu, Qxu, Qxu, Qxu, Qxu, Qxu, Qxu
Xu, Xu, Re, Rb^Ii, Re, Xu, Xu, Xu, Xu, Qxu, Qxu, Qxu, Qxu, Qxu, Qxu, Qxu, Qxu, Qxu, Qxu, Qxu, Qxu, Qxu, Qxu, Qxu, Qxu, Qxu, Qxu, Qxu, Qxu, Qxu, Qxu, Qxu, Qxu, Qxu, Qxu
Xu, Xu, Re, Rb^Ii, Re, Xu, Xu, Xu, Xu, Qxu, Qxu, Qxu, Qxu, Qxu, Qxu, Qxu, Qxu, Qxu, Qxu, Qxu, Qxu, Qxu, Qxu, Qxu, Qxu, Qxu, Qxu, Qxu, Qxu, Qxu, Qxu, Qxu, Qxu, Qxu, Qxu
Xu, Xu, Re, Rb^Ii, Re, Xu, Xu, Xu, Xu, Qxu, Qxu, Qxu, Qxu, Qxu, Rb^QcnZ, Rb^QcnZ, Rb^QcsZ, Qxu, Qxu, Qxu, Qxu, Qxu, Qxu, Qxu, Qxu, Qxu, Qxu, Qxu, Qxu, Qxu, Qxu, Qxu, Qxu, Qxu, Qxu
Xu, Xu, Re, Rb^Ii, Rb^Ii, Re, Re, Xu, Rb^QcsZ, Qxu, Qxu, Qxu, Rb^QcnZ, Rb^QcnZ, Re, Re, Re, Rb^QcsZ, Rb^QcsZ, Qxu, Rb^QcnZ, Qxu, Qxu, Qxu, Qxu, Qxu, Qxu, Qxu, Qxu, Qxu, Qxu, Qxu, Qxu, Qxu, Qxu
Xu, Xu, Xu, Re, Re, Rb^Ii, Rb^Ii, Re, Re, Rb^QcsZ, Rb^QcnZ, Rb^QcnZ, Rb^Ii, Re, Rb^Ii, Rb^Ii, Rb^Ii, Re, Rb^Ii, Rb^QcnZ, Re, Rb^QcsZ, Rb^QcnZ, Rb^QcnZ, Rb^QcsZ, Qxu, Rb^QcnZ, Qxu, Qxu, Qxu, Qxu, Qxu, Xu, Qxu, Xu
Xu, Xu, Xu, Xu, Rb^QcsZ, Rb^QcsZ, Rb^QcnZ, Rb^Ii, Rb^Ii, Re, Rb^Ii, Rb^Ii, Re, Rb^Ii, Rb^QcsZ, Rb^QcsZ, Rb^QcnZ, Rb^Ii, Re, Rb^Ii, Rb^Ii, Re, Re, Re, Rb^Ii, Rb^QcnZ, Re, Rb^QcsZ, Rb^QcsZ, Qxu, Qxu, Xu, Xu, Xu, Xu
Xu, Xu, Xu, Xu, Qxu, Qxu, Qxu, Rb^QcnZ, Rb^QcnZ, Rb^Ii, Re, Re, Rb^QcsZ, Rb^QcsZ, Xu, Qxu, Qxu, Rb^QcnZ, Rb^QcnZ, Re, Rb^QcsZ, Rb^Ii, Rb^Ii, Rb^Ii, Re, Rb^Ii, Rb^Ii, Re, Re, Rb^QcsZ, Rb^QcsZ, Xu, Xu, Xu, Xu
Xu, Xu, Qxu, Qxu, Qxu, Qxu, Qxu, Qxu, Rb^QcnZ, Rb^Ii, Re, Rb^QcsZ, Qxu, Xu, Xu, Qxu, Qxu, Qxu, Qxu, Rb^QcsZ, Qxu, Rb^QcnZ, Rb^QcsZ, Rb^QcsZ, Rb^QcnZ, Re, Rb^QcsZ, Rb^Ii, Rb^Ii, Re, Re, Rb^QcsZ, Xu, Xu, Xu
Xu, Xu, Qxu, Qxu, Qxu, Qxu, Qxu, Qxu, Rb^QcnZ, Rb^Ii, Re, Rb^QcsZ, Qxu, Qxu, Xu, Xu, Cud, Qxu, Qxu, Qxu, Qxu, Qxu, Qxu, Qxu, Qxu, Rb^QcsZ, Qxu, Rb^QcnZ, Rb^QcnZ, Rb^Ii, Re, Rb^QcsZ, Xu, Xu, Xu
Xu, Xu, Xu, Qxu, Qxu, Qxu, Rb^QcnZ, Rb^QcnZ, Rb^Ii, Rb^Ii, Re, Rb^QcsZ, Qxu, Qxu, Qxu, Cud, Xu, Xu, Qxu, Qxu, Qxu, Qxu, Xu, Qxu, Qxu, Qxu, Qxu, Qxu, Qxu, Rb^Ii, Qxu, Rb^QcsZ, Xu, Xu, Xu
Xu, Xu, Xu, Qxu, Qxu, Rb^QcnZ, Re, Rb^Ii, Re, Re, Rb^QcsZ, Rb^QcsZ, Xu, Qxu, Qxu, Qxu, Qxu, Xu, Xu, Qxu, Xu, Xu, Xu, Xu, Xu, Xu, Xu, Qxu, Qxu, Qxu, Qxu, Qxu, Xu, Xu, Xu
Xu, Xu, Xu, Qxu, Qxu, Rb^QcnZ, Re, Rb^Ii, Re, Rb^QcsZ, Qxu, Xu, Xu, Xu, Xu, Qxu, Xu, Xu, Xu, Xu, Xu, Xu, Xu, Xu, Xu, Xu, Qxu, Qxu, Qxu, Qxu, Qxu, Qxu, Qxu, Xu, Xu
Xu, Xu, Xu, Xu, Qxu, Rb^QcnZ, Rb^QcnZ, Rb^Ii, Qxu, Qxu, Qxu, Xu, Xu, Xu, Xu, Xu, Xu, Xu, Xu, Xu, Xu, Xu, Xu, Xu, Qxu, Qxu, Qxu, Qxu, Qxu, Qxu, Qxu, Qxu, Qxu, Xu, Xu
Xu, Xu, Xu, Xu, Xu, Qxu, Xu, Qxu, Qxu, Qxu, Qxu, Qxu, Qxu, Qxu, Qxu, Xu, Xu, Xu, Xu, Xu, Xu, Xu, Xu, Xu, Qxu, Qxu, Qxu, Qxu, Qxu, Qxu, Qxu, Qxu, Xu, Xu, Xu
Xu, Xu, Xu, Xu, Xu, Xu, Xu, Xu, Qxu, Qxu, Qxu, Qxu, Qxu, Qxu, Qxu, Xu, Xu, Xu, Xu, Xu, Xu, Xu, Xu, Qxu, Qxu, Qxu, Qxu, Qxu, Qxu, Qxu, Qxu, Qxu, Xu, Xu, Xu
Xu, Xu, Xu, Xu, Xu, Xu, Xu, Xu, Qxu, Qxu, Qxu, Qxu, Qxu, Qxu, Qxu, Qxu, Xu, Xu, Xu, Xu, Xu, Xu, Xu, Qxu, Qxu, Qxu, Qxu, Qxu, Qxu, Qxu, Qxu, Qxu, Xu, Xu, Xu
Xu, Xu, Xu, Xu, Xu, Xu, Qxu, Qxu, Qxu, Qxu, Qxu, Qxu, Qxu, Qxu, Qxu, Qxu, Xu, Xu, Xu, Xu, Xu, Xu, Xu, Qxu, Qxu, Qxu, Qxu, Qxu, Qxu, Qxu, Qxu, Qxu, Xu, Xu, Xu
Xu, Xu, Xu, Xu, Xu, Xu, Qxu, Qxu, Qxu, Qxu, Qxu, Qxu, Qxu, Qxu, Qxu, Qxu, Qxu, Xu, Xu, Xu, Qxu, Xu, Qxu, Qxu, Qxu, Qxu, Qxu, Qxu, Qxu, Qxu, Qxu, Xu, Xu, Xu, Xu
Xu, Xu, Xu, Xu, Xu, Xu, Xu, Qxu, Qxu, Qxu, Qxu, Qxu, Qxu, Qxu, Qxu, Qxu, Qxu, Qxu, Qxu, Qxu, Qxu, Qxu, Qxu, Qxu, Qxu, Qxu, Qxu, Qxu, Qxu, Qxu, Xu, Xu, Xu, Xu, Xu
Xu, Xu, Xu, Xu, Xu, Xu, Xu, Xu, Xu, Xu, Xu, Qxu, Xu, Qxu, Qxu, Qxu, Qxu, Qxu, Qxu, Qxu, Qxu, Qxu, Qxu, Qxu, Qxu, Qxu, Qxu, Qxu, Xu, Xu, Xu, Xu, Xu, Xu, Xu
Xu, Xu, Xu, Xu, Xu, Xu, Xu, Xu, Xu, Xu, Xu, Xu, Xu, Xu, Xu, Qxu, Ur, Qxu, Qxu, Qxu, Ur, Qxu, Qxu, Qxu, Ur, Qxu, Xu, Xu, Xu, Xu, Xu, Xu, Xu, Xu, Xu
Xu, Xu, Xu, Xu, Xu, Xu, Xu, Xu, Xu, Xu, Xu, Xu, Xu, Xu, Xu, Ur, Ur, Ur, Ur, Ur, Ur, Ur, Ur, Ur, Ur, Ur, Xu, Xu, Xu, Xu, Xu, Xu, Xu, Xu, Xu
Xu, Xu, Xu, Xu, Xu, Xu, Xu, Xu, Xu, Xu, Xu, Xu, Xu, Xu, Xu, Ur, Ur, Ur, Ur, Ur, Ur, Ur, Ur, Ur, Ur, Ur, Xu, Xu, Xu, Xu, Xu, Xu, Xu, Xu, Xu
