Xu, Xu, Xu, Xu, Xu, Xu, Xu, Xu, Xu, Xu, Xu, Xu, Xu, Xu, Xu, Xu, Qxu, Qxu, Qxu, Qxu, Qxu, Qxu, Qxu, Xu, Xu, Xu, Xu, Xu, Xu, Xu, Xu, Xu, Xu, Xu, Xu
Xu, Xu, Xu, Xu, Xu, Xu, Rb^QcsZ, Xu, Xu, Xu, Qxu, Qxu, Qxu, Xu, Qxu, Qxu, Qxu, Qxu, Rb^QcnZ, Qxu, Qxu, Qxu, Qxu, Qxu, Xu, Xu, Xu, Xu, Xu, Xu, Xu, Xu, Xu, Xu, Xoa
Xu, Xu, Uu^Tf, Rb^QcsZ, Uu, Uu^Tf, Rb^QcsZ, Xu, Xu, Xu, Qxu, Qxu, Qxu, Qxu, Qxu, Qxu, Rb^QcnZ, Rb^QcnZ, Uu^Tf, Rb^QcsZ, Rb^QcnZ, Rb^QcnZ, Rb^QcsZ, Qxu, Qxu, Xu, Xu, Xu, Xu, Xu, Xu, Xu, Xoa, Xoa, Xoa
Xu, Xu, Uu, Rb^QcsZ, Uu, Rb^QcsZ, Xu, Xu, Xu, Xu, Rb^QcnZ, Qxu, Qxu, Qxu, Xu, Rb^QcnZ, Xu, Uu, Uu^Tf, Uu, Uu^Tf, Uu^Tf, Rb^QcsZ, Qxu, Qxu, Xu, Xu, Xu, Xu, Xu, Xoa, Xoa, Xoa^Efs, Xoa, Uu
Xu, Xu, Uu, Rb^QcsZ, Uu^Tf, Rb^QcsZ, Rb^QcsZ, Xu, Rb^QcnZ, Rb^QcnZ, Re, Rb^QcsZ, Rb^QcsZ, Xu, Xu, Xu, Uu^Tf, Rb^QcsZ, Rb^QcsZ, Uu, Uu, Uu, Xu, Qxu, Qxu, Qxu, Xu, Xu, Xoa, Xoa, Xoa^Efs, Xoa, 1 Isa, Uu, Isa
Xu, Xu, Xu, Uu^Tf, Uu, Uu, Re, Rb^QcnZ, Re, Re, Rb^Ii, Re, Re, Rb^QcsZ, Rb^QcsZ, Uu, Uu^Tf, Uu, Rb, Rb^QcsZ, Rb^QcsZ, Rb, Uu, Xu, Rb^QcnZ, Rb^QcnZ, Uu, Xoa^Efs, Xoa, Xoa, Isa, Isa, Uu, Isa, Xoa
Xu, Xu, Xu, Xu, Re, Re, Rb^Ii, Rb^Ii, Rb^Ii, Rb^Ii, Re, Rb^Ii, Rb^Ii, Re, Rb^QcsZ, Rb, Rb, Rb, Rb, Rb, Uu, Rb, Uu, Uu^Tf, Rb, Uu, Ur, Ur, Uu, Uu, Isa, Uu, Xoa, Xoa, Xoa
Xu, Xu, Re, Re, Rb^Ii, Rb^Ii, Re, Re, Rb^QcsZ, Rb^QcsZ, Rb^QcnZ, Re, Re, Rb^Ii, Re, Rb^QcsZ, Rb^QcsZ, Uu^Tf, Rb^QcnZ, Uu^Tf, Uu, Uu, Rb^QcnZ, Rb, Uu, Uu, Ur, Ur, Ur, Isa, Ur, Xoa^Efs, Xoa, Xoa, Xoa
Xu, Xu, Re, Rb^Ii, Re, Re, Xu, Rb^QcsZ, Qxu^Xo, Qxu, Qxu, Rb^QcnZ, Rb^QcnZ, Rb^Ii, Rb^Ii, Re, Re, Rb^QcnZ, Re, Rb^QcsZ, Rb^QcnZ, Rb^QcnZ, Re, Re, Uu, Ur, Ur, Ur, Ur, Ur, Ur, Uu, Xu, Xoa, Xoa
Xu, Xu, Xu, Rb^Ii, Re, Xu, Xu, Xu, Uu^Tf, Qxu^Xo, Qxu^Xo, Qxu, Rb^QcnZ, Re, Re, Rb^Ii, Rb^Ii, Rb^Ii, Rb^Ii, Re, Re, Re, Rb^Ii, Rb^Ii, Re, Uu, Uu, Ur, Uu, Ur, Uu, Uu, Xu, Xu, Xu
Xu, Xu, Xu, Rb^Ii, Re, Xu, Xu, Xu, Xu, Uu, Qxu^Xo, Qxu, Qxu, Rb^QcnZ, Rb^QcnZ, Re, Rb^QcsZ, Re, Re, Rb^Ii, Rb^Ii, Rb^Ii, Rb^QcsZ, Re, Rb^QcsZ, Rb^QcsZ, Rb^QcnZ, Uu, Rb^QcsZ, Uu, Rb^QcsZ, Rb^QcsZ, Xu, Xu, Xu
Xu, Xu, Re, Rb^Ii, Re, Xu, Xu, Xu, Xu, Uu^Tf, Qxu, Qxu^Xo, Qxu^Xo, Qxu, Qxu, Rb^QcsZ, Qxu, Rb^QcnZ, Rb^QcnZ, Re, Rb^QcsZ, Rb^QcsZ, Qxu, Rb^QcsZ, Uu, Uh^Tf, Uu^Tf, Rb^QcsZ, Uh, Rb^QcsZ, Qxu, Qxu, Xu, Xu, Xu
Xu, Xu, Re, Rb^Ii, Re, Xu, Xu, Xu, Xu, Xu, Qxu, Qxu, Qxu, Qxu^Xo, Qxu^Xo, Qxu, Qxu^Xo, Qxu^Xo, Qxu^Xo, Rb^QcsZ, Qxu, Qxu, Qxu^Xo, Qxu, Qxu, Uu, Xu, Uu, Uu, Uu^Tf, Qxu, Qxu, Qxu^Xo, Xu, Xu
Xu, Xu, Re, Rb^Ii, Re, Xu, Xu, Xu, Xu, Xu, Rb^QcnZ, Rb^QcnZ, Rb^QcsZ, Qxu, Qxu, Qxu^Xo, Qxu, Qxu, Qxu, Qxu^Xo, Qxu^Xo, Qxu^Xo, Qxu, Qxu^Xo, Qxu^Xo, Qxu^Xo, Xu, Xu, Xu, Qxu^Xo, Qxu^Xo, Qxu^Xo, Qxu, Xu, Xu
Xu, Xu, Re, Rb^Ii, Rb^Ii, Re, Re, Xu, Xu, Xu, Re, Re, Rb^Ii, Rb^QcsZ, Rb^QcsZ, Qxu, Rb^QcnZ, Rb^QcnZ, Rb^QcsZ, Qxu, Qxu, Qxu, Rb^QcnZ, Qxu, Qxu, Qxu, Re, Xu, Rb^QcsZ, Qxu, Qxu, Qxu, Qxu, Qxu, Xu
Xu, Xu, Xu, Re, Re, Rb^Ii, Rb^Ii, Re, Re, Re, Rb^Ii, Rb^Ii, Re, Rb^Ii, Rb^Ii, Rb^QcnZ, Re, Re, Re, Rb^QcsZ, Rb^QcnZ, Rb^QcnZ, Re, Rb^QcsZ, Rb^QcsZ, Re, Re, Re, Re, Rb^QcsZ, Rb^QcsZ, Qxu, Qxu, Qxu, Qxu
Xu, Xu, Xu, Xu, Xu, Re, Re, Rb^Ii, Rb^Ii, Rb^Ii, Rb^QcsZ, Rb^QcsZ, Uu, Re, Re, Rb^Ii, Rb^Ii, Rb^Ii, Rb^Ii, Re, Re, Re, Rb^Ii, Rb^Ii, Rb^Ii, Rb^QcsZ, Rb^QcsZ, Re, Re, Re, Rb^QcsZ, Qxu, Qxu, Qxu, Qxu
Xu, Xu, Xu, Xu, Xu, Rb^QcnZ, Rb^QcnZ, Re, Rb^QcsZ, Rb^QcsZ, Re, Uu, Re, Rb^QcnZ, Rb^QcnZ, Re, Rb^QcsZ, Rb^QcsZ, Rb^QcnZ, Rb^Ii, Rb^Ii, Rb^Ii, Re, Re, Re, Rb^Ii, Rb^Ii, Rb^QcsZ, Re, Re, Rb^QcsZ, Qxu, Qxu, Qxu, Qxu
Xu, Xu, Xu, Xu, Qxu, Qxu, Qxu, Rb^QcsZ, Qxu, Qxu, Uu, Uu^Tf, Qxu, Qxu, Qxu, Rb^QcsZ, Qxu, Qxu, Qxu, Rb^QcnZ, Rb^QcnZ, Re, Rb^QcsZ, Rb^QcsZ, Rb^QcnZ, Re, Rb^Ii, Re, Re, Re, Qxu, Qxu, Xu, Xu, Xu
Xu, Xu, Xu, Xu, Xu, Qxu, Qxu, Qxu, Qxu, Re, Re, Uu, Xu, Qxu, Qxu, Qxu, Xu, Qxu, Qxu, Qxu, Qxu, Rb^QcsZ, Qxu, Qxu, Qxu, Rb^QcnZ, Rb^QcnZ, Rb^Ii, Rb^Ii, Rb^QcsZ, Rb^QcsZ, Qxu, Xu, Xu, Xu
Xu, Xu, Xu, Xu, Xu, Xu, Xu, Qxu, Uu^Tf, Uu, Re, Xu, Xu, Xu, Xu, Xu, Xu, Xu, Uu, Qxu, Qxu, Qxu, Qxu, Qxu, Uu, Qxu, Xu, Re, Re, Rb^Ii, Re, Xu, Xu, Xu, Xu
Xu, Xu, Qlf^Ii, Ql, Uu, Xu, Xu, Uu^Tf, Uu, Re, Xu, Xu, Xu, Xu, Xu, Xu, Uu^Tf, Xu, Xu, Uu^Tf, Xu, Uu, Uu^Tf, Uu^Tf, Xu, Xu, Xu, Xu, Re, Rb^Ii, Re, Xu, Xu, Xu, Xu
Xu, Xu, Qlf^Ii, Qlf^Ii, Rb, Xu, Xu, Xu, Xu, Xu, Xu, Xu, Uu^Tf, Uu, Uu, Uu^Tf, Ss, Uu, Xu, Xu, Xu, Xu, Xu, Xu, Xu, Xu, Xu, Xu, Re, Rb^Ii, Rb^Ii, Re, Xu, Xu, Xu
Xu, Xu, Xu, Ql, Ql, Rb, Xu, Xu, Xu, Xu, Uu, Uu^Tf, Ss, Ss, Urb, Sm^Qhu, Sm^Qhu, Ss, Uu^Tf, Xu, Xu, Xu, Qxu, Xu, Qxu, Xu, Xu, Xu, Xu, Re, Rb^Ii, Re, Xu, Xu, Xu
Xu, Xu, Xu, Qlf, Ql, Uu, Xu, Xu, Xu, Xu, Ss, Sm^Qhu, Urb, Urb, Sm^Qhu, Urb, Urb, Sm^Qhu, Ss, Uu^Tf, Xu, Xu, Qxu, Qxu, Qxu, Qxu, Xu, Xu, Xu, Re, Rb^Ii, Re, Xu, Xu, Xu
Xu, Xu, Xu, Xu, Uu, Ql, Xu, Xu, Xu, Uu, Ss, Sm^Qhu, Urb, Sm^Qhu, Sm^Qhu, Sm^Qhu, Urb, Ss, Ss, Uu, Uu, Qxu, Qxu, Qxu, Qxu, Qxu, Xu, Xu, Xu, Re, Rb^Ii, Re, Xu, Xu, Xu
Xu, Xu, Xu, Xu, Rb, Ql, Qlf, Xu, Xu, Uu, Uu, Sm^Qhu, Uu, Urb, Urb, Urb, Sm^Qhu, Sm^Qhu, Rb^QcnZ, Re, Re, Uu, Rb^QcnZ, Rb^QcnZ, Rb^QcsZ, Qxu, Xu, Xu, Xu, Re, Rb^Ii, Re, Xu, Xu, Xu
Xu, Xu, Xu, Rb, Ql, Ql, Qlf, Xu, Xu, Xu, Xu, Uu^Tf, Ss, Ss, Rb^QcnZ, Uu^Tf, Rb^QcnZ, Rb^QcnZ, Re, Re, Re, Rb^QcnZ, Rb^Ii, Re, Re, Xu, Xu, Xu, Re, Re, Rb^Ii, Re, Xu, Xu, Xu
Xu, Xu, Xu, Uu, Ql, Ql, Ql, Xu, Xu, Xu, Xu, Uu, Re, Rb^QcnZ, Re, Rb^QcnZ, Re, Re, Rb^Ii, Re, Rb^Ii, Rb^Ii, Re, Rb^Ii, Rb^Ii, Re, Re, Re, Rb^Ii, Rb^Ii, Re, Re, Xu, Xu, Xu
Xu, Xu, Xu, Xu, Rb^QcnZ, Rb^QcnZ, Rb^QcsZ, Xu, Xu, Xu, Rb^QcnZ, Re, Re, Re, Rb^Ii, Re, Rb^Ii, Rb^Ii, Re, Rb^Ii, Re, Re, Rb^QcsZ, Re, Re, Rb^Ii, Rb^Ii, Rb^Ii, Rb^QcsZ, Re, Xu, Xu, Xu, Xu, Xu
Xu, Xu, Xu, Xu, Re, Re, Rb^Ii, Rb^QcsZ, Rb^QcnZ, Rb^QcnZ, Re, Re, Rb^Ii, Rb^Ii, Re, Rb^Ii, Rb^QcsZ, Rb^QcsZ, Rb^QcnZ, Re, Rb^QcsZ, Rb^QcsZ, Xu, Rb^QcnZ, Rb^QcnZ, Re, Rb^QcsZ, Rb^QcsZ, Qxu, Xu, Xu, Xu, Xu, Xu, Xu
Xu, Xu, Re, Re, Rb^Ii, Rb^Ii, Re, Rb^Ii, Rb^Ii, Re, Rb^Ii, Rb^Ii, Re, Re, Rb^QcsZ, Rb^QcsZ, Qxu, Qxu, Xu, Rb^QcsZ, Xu, Xu, Xu, Xu, Xu, Rb^QcsZ, Xu, Qxu, Qxu, Qxu, Qxu, Xu, Xu, Xu, Xu
Xu, Xu, Re, Rb^Ii, Re, Re, Xu, Re, Re, Rb^Ii, Rb^QcsZ, Rb^QcsZ, Re, Uh, Uu, Qxu, Qxu, Qxu, Xu, Xu, Uh^QcsZ, Uh^QcsZ, Uh^QcnZ, Xu, Kte, Xu, Xu, Qxu^Xo, Qxu^Xo, Qxu, Qxu, Xu, Cte, Xu, Xu
Xu, Xu, Re, Rb^Ii, Re, Xu, Xu, Xu, Rb^QcsZ, Rb^QcsZ, Uu^Tf, Uu, Uh, Uu^Tf, Uu^Tf, Qxu, Qxu^Xo, Xu, Xu, Xu, Uu, Re, Uh, Uh^QcnZ, Cte, Cte, Cte, Rb^QcsZ, Qxu, Qxu^Xo, Qxu, Cte, Kte, Xu, Xu
Xu, Xu, Re, Rb^Ii, Re, Xu, Xu, Xu, Xu, Cte, Cte, Cte, Re, Uu, Qxu^Xo, Qxu, Qxu^Xo, Xu, Xu, Uu, Re, Re, Uh, Uh^QcnZ, Uu, Re, Cte, Rb^QcsZ, Qxu, Qxu^Xo, Qxu^Xo, Uh, Cte, Cte, Xu
Xu, Xu, Re, Rb^Ii, Re, Xu, Xu, Xu, Xu, Kte, Cte, Cte, Xu, Qxu^Xo, Qxu, Qxu^Xo, Xu, Xu, Xu, Re, Uu, Uh^QcsZ, Uh^QcsZ, Uu, Re, Re, Rb^QcsZ, Rb^QcsZ, Xu, Qxu, Qxu^Xo, Uh^Tf, Cte, Xu, Xu
Xu, Xu, Re, Rb^Ii, Re, Xu, Xu, Xu, Xu, Xu, Xu, Xu, Xu, Qxu, Rb^QcnZ, Rb^QcnZ, Rb^QcsZ, Xu, Uu, Re, Re, Uu, Re, Re^QcsZ, Xu, Re, Xu, Xu, Xu, Qxu^Xo, Qxu, Qxu, Qxu, Qxu, Qxu
Xu, Xu, Re, Rb^Ii, Rb^Ii, Re, Re, Xu, Rb^QcsZ, Xu, Xu, Xu, Rb^QcnZ, Rb^QcnZ, Re, Re, Re, Rb^QcsZ, Rb^QcsZ, Uu, Rb^QcnZ, Uu, Uu, Re, Xu, Xu, Xu, Uu^Tf, Uu, Qxu, Qxu, Qxu, Qxu, Qxu, Qxu
Xu, Xu, Xu, Re, Re, Rb^Ii, Rb^Ii, Re, Re, Rb^QcsZ, Rb^QcnZ, Rb^QcnZ, Rb^Ii, Re, Rb^Ii, Rb^Ii, Rb^Ii, Re, Rb^Ii, Rb^QcnZ, Re, Rb^QcsZ, Rb^QcnZ, Rb^QcnZ, Rb^QcsZ, Xu, Rb^QcnZ, Uu, Qxu, Qxu, Qxu, Qxu, Xu, Qxu, Xu
Xu, Xu, Xu, Xu, Rb^QcsZ, Rb^QcsZ, Rb^QcnZ, Rb^Ii, Rb^Ii, Re, Rb^Ii, Rb^Ii, Re, Rb^Ii, Rb^QcsZ, Rb^QcsZ, Rb^QcnZ, Rb^Ii, Re, Rb^Ii, Rb^Ii, Re, Re, Re, Rb^Ii, Rb^QcnZ, Re, Rb^QcsZ, Rb^QcsZ, Qxu, Qxu, Uu^Tf, Xu, Xu, Xu
Xu, Xu, Xu, Xu, Qxu, Qxu, Qxu, Rb^QcnZ, Rb^QcnZ, Rb^Ii, Re, Re, Rb^QcsZ, Rb^QcsZ, Xu, Qxu, Qxu, Rb^QcnZ, Rb^QcnZ, Re, Rb^QcsZ, Rb^Ii, Rb^Ii, Rb^Ii, Re, Rb^Ii, Rb^Ii, Re, Re, Rb^QcsZ, Rb^QcsZ, Xu, Xu, Xu, Xu
Xu, Xu, Qxu, Qxu, Qxu, Qxu, Qxu, Qxu, Rb^QcnZ, Rb^Ii, Re, Rb^QcsZ, Qxu, Xu, Xu, Qxu, Qxu, Qxu, Qxu, Rb^QcsZ, Qxu, Rb^QcnZ, Rb^QcsZ, Rb^QcsZ, Rb^QcnZ, Re, Rb^QcsZ, Rb^Ii, Rb^Ii, Re, Re, Rb^QcsZ, Xu, Xu, Xu
Xu, Xu, Qxu, Qxu, Qxu, Qxu, Qxu, Qxu, Rb^QcnZ, Rb^Ii, Re, Rb^QcsZ, Qxu, Qxu, Xu, Xu, Cud, Qxu, Qxu, Qxu, Qxu, Qxu, Qxu, Qxu, Qxu, Rb^QcsZ, Qxu, Rb^QcnZ, Rb^QcnZ, Rb^Ii, Re, Rb^QcsZ, Xu, Xu, Xu
Xu, Xu, Cud, Qxu, Qxu, Qxu, Rb^QcnZ, Rb^QcnZ, Rb^Ii, Rb^Ii, Re, Rb^QcsZ, Qxu, Qxu, Qxu, Cud, Xu, Xu, Qxu, Qxu, Qxu, Qxu, Cud, Qxu, Qxu, Qxu, Qxu, Qxu, Re, Rb^Ii, Re, Rb^QcsZ, Xu, Xu, Xu
Xu, Xu, Xu, Qxu, Qxu, Rb^QcnZ, Re, Rb^Ii, Re, Re, Rb^QcsZ, Rb^QcsZ, Xu, Qxu, Qxu, Qxu, Qxu, Xu, Xu, Qxu, Xu, Cud, Xu, Xu, Xu, Xu, Xot^Efs, Xot, Urb, Re, Xot^Efs, Re, Xu, Xu, Xu
Xu, Xu, Xu, Qxu, Qxu, Rb^QcnZ, Re, Rb^Ii, Re, Rb^QcsZ, Uu^Tf, Xu, Xu, Xu, Xu, Qxu, Xu, Xu, Xu, Xu, Xu, Xu, Xu, Xu, Xot, Xot, Urb, Urb, Urb, Urb, Urb, Xot, Xot, Xu, Xu
Xu, Xu, Xu, Xu, Qxu, Rb^QcnZ, Rb^QcnZ, Rb^Ii, Re^Ii, Re^QcsZ, Re^QcsZ, Xu, Xu, Xu, Xu, Xu, Xu, Xu, Xu, Xu, Xu, Xu, Xot, Xot, Urb, Urb, Urb, Urb, Xot^Efs, Urb, Urb, Urb, Xot, Xu, Xu
Xu, Xu, Xu, Xu, Xu, Qxu, Xu, Re^QcnZ, Re^QcnZ, Re^Ii, Re^Ii, Re^QcsZ, Re^QcsZ, Uh^Tf, Uh, Xu, Xu, Xu, Xu, Xu, Xu, Xu, Xu, Xot, Xot, Urb, Urb, Urb, Urb, Xot, Xot, Xot, Xu, Xu, Xu
Xu, Xu, Xu, Xu, Xu, Xu, Xu, Xu, Re^QcnZ, Re, Re^Ii, Re, Re^QcsZ, Uu, Uu, Xu, Xu, Xu, Xu, Xu, Xu, Xu, Xu, Xu, Xot, Xot^Efs, Xot, Urb, Urb, Urb, Urb, Xot, Xot, Xu, Xu
Xu, Xu, Xu, Xu, Xu, Xu, Xu, Xu, Uu^Tf, Re^QcnZ, Re, Re^Ii, Re, Re^QcsZ, Uh^Tf, Uh, Xu, Xu, Xu, Xu, Xu, Xu, Xu, Xot, Urb, Urb, Urb, Xot, Urb, Urb, Urb, Xot, Xu, Xu, Xu
Xu, Xu, Xu, Xu, Xu, Xu, Xu, Rb, Uh^Tf, Rb, Re^QcnZ, Re^Ii, Re^Ii, Re^QcsZ, Re^QcsZ, Uu^Tf, Xu, Xu, Xu, Xu, Xu, Xu, Xot, Xot, Xot^Efs, Urb, Urb, Urb, Urb, Urb, Xot, Xot, Xu, Xu, Xu
Xu, Xu, Xu, Xu, Xu, Xu, Xu, Uh, Uu, Rb, Uu, Re^QcnZ, Re, Re^Ii, Re^Ii, Re^QcsZ, Re^QcsZ, Xu, Xu, Xu, Xot^Efs, Xot, Urb, Urb, Urb, Xot, Urb, Urb, Urb, Xot^Efs, Xot, Xu, Xu, Xu, Xu
Xu, Xu, Xu, Xu, Xu, Xu, Xu, Uu^Tf, Rb, Uu^Tf, Uh, Re^QcnZ, Re^QcnZ, Re, Re, Re^Ii, Re, Re, Re, Re, Re, Urb, Urb, Urb, Urb, Urb, Urb, Urb, Urb, Urb, Xot, Xu, Xu, Xu, Xu
Xu, Xu, Xu, Xu, Xu, Xu, Xu, Xu, Xu, Xu, Xu, Uh, Xu, Re^QcnZ, Re^QcnZ, Re, Re, Re, Re, Re, Re, Re, Re, Xot^Efs, Xot, Urb, Xot, Xot, Xot, Xot, Xu, Xu, Xu, Xu, Xu
Xu, Xu, Xu, Xu, Xu, Xu, Xu, Xu, Xu, Xu, Xu, Xu, Xu, Xu, Xu, Re, Ur, Re, Re, Re, Ur, Re, Re, Re, Ur, Xot, Xot, Xot, Xu, Xu, Xu, Xu, Xu, Xu, Xu
Xu, Xu, Xu, Xu, Xu, Xu, Xu, Xu, Xu, Xu, Xu, Xu, Xu, Xu, Xu, Ur, Ur, Ur, Ur, Ur, Ur, Ur, Ur, Ur, Ur, Ur, Xu, Xu, Xu, Xu, Xu, Xu, Xu, Xu, Xu
Xu, Xu, Xu, Xu, Xu, Xu, Xu, Xu, Xu, Xu, Xu, Xu, Xu, Xu, Xu, Ur, Ur, Ur, Ur, Ur, Ur, Ur, Ur, Ur, Ur, Ur, Xu, Xu, Xu, Xu, Xu, Xu, Xu, Xu, Xu
