Xu, Xu, Xu, Xu, Xu, Xu, Xu, Xu, Qxu, Qxu, Qxu, Qxu, Qxu, Qxu, Qxu, Qxu, Qxu, Qxu, Qxu, Qxu, Qxu, Qxu, Qxu, Xu, Xu, Xu, Xu, Xu, Xu, Xu, Xu, Xu, Xu, Xu, Xu
Xu, Xu, Xu, Xu, Qxu, Qxu, Qxu, Qxu, Qxu, Qxu, Qxu, Qxu, Qxu, Qxu, Qxu, Qxu, Qxu, Qxu, Qxu, Qxu, Qxu, Qxu, Qxu, Qxu, Qxu, Xu, Xu, Xu, Xu, Xu, Xu, Xu, Xu, Xu, Xoa
Xu, Xu, Qxu, Qxu, Qxu, Qxu, Qxu, Qxu, Qxu, Qxu, Qxu, Qxu, Qxu, Qxu, Qxu, Qxu, Qxu, Qxu, Qxu, Qxu, Qxu, Qxu, Qxu, Qxu, Qxu, Xu, Xu, Xu, Xu, Xu, Xu, Xu, Xoa, Xoa, Xoa
Xu, Xu, Qxu, Qxu, Qxu, Qxu, Qxu, Qxu, Qxu, Qxu, Rrd^QcnZ, Qxu, Qxu, Qxu, Qxu, Qxu, Qxu, Qxu, Qxu, Qxu, Qxu, Qxu, Qxu, Qxu, Qxu, Qxu, Xu, Xu, Xu, Xu, Xoa, Xoa, Xoa, Xoa, Uu
Xu, Xu, Qxu, Qxu, Qxu, Qxu, Rrd^QcnZ, Rrd^QcnZ, Rrd^QcnZ, Rrd^QcnZ, Re, Rrd^QcsZ, Rrd^QcsZ, Qxu, Qxu, Qxu, Qxu, Qxu, Qxu, Qxu, Qxu, Qxu, Qxu, Qxu, Qxu, Qxu, Xu, Xu, Xoa, Xoa, Xoa, Xoa, Isa, Uu, Isa
Xu, Xu, Xu, Qxu, Rrd^QcnZ, Rrd^QcnZ, Re, Re, Re, Re, Re^Ii, Re, Re, Rrd^QcsZ, Rrd^QcsZ, Qxu, Qxu, Qxu, Qxu, Qxu, Qxu, Qxu, Qxu, Qxu, Rrd^QcnZ, Rrd^QcnZ, Uu, Xoa, Xoa, Xoa, Isa, Isa, Uu, Isa, Xoa
Xu, Xu, Xu, Xu, Re, Re, Re^Ii, Re^Ii, Re^Ii, Re^Ii, Re, Re^Ii, Re^Ii, Re, Rrd^QcsZ, Qxu, Qxu, Qxu, Qxu, Qxu, Qxu, Qxu, Qxu, Qxu, Rrd^QcnZ, Uu, Ur, Ur, Uu, Uu, Isa, Uu, Xoa, Xoa, Xoa
Xu, Xu, Re, Re, Re^Ii, Re^Ii, Re, Re, Rrd^QcsZ, Rrd^QcsZ, Rrd^QcnZ, Re, Re, Re^Ii, Re, Rrd^QcsZ, Rrd^QcsZ, Qxu, Rrd^QcnZ, Qxu, Qxu, Qxu, Rrd^QcnZ, Rrd^QcnZ, Uu, Uu, Ur, Ur, Ur, Isa, Ur, Xoa, Xoa, Xoa, Xoa
Xu, Xu, Re, Re^Ii, Re, Re, Xu, Rrd^QcsZ, Qxu, Qxu, Qxu, Rrd^QcnZ, Rrd^QcnZ, Re^Ii, Re^Ii, Re, Re, Rrd^QcnZ, Re, Rrd^QcsZ, Rrd^QcnZ, Rrd^QcnZ, Re, Re, Uu, Ur, Ur, Ur, Ur, Ur, Ur, Uu, Xu, Xoa, Xoa
Xu, Xu, Xu, Re^Ii, Re, Xu, Xu, Xu, Qxu, Qxu, Qxu, Qxu, Rrd^QcnZ, Re, Re, Re^Ii, Re^Ii, Re^Ii, Re^Ii, Re, Re, Re, Re^Ii, Re^Ii, Re, Uu, Uu, Ur, Uu, Ur, Uu, Uu, Xu, Xu, Xu
Xu, Xu, Xu, Re^Ii, Re, Xu, Xu, Xu, Xu, Qxu, Qxu, Qxu, Qxu, Rrd^QcnZ, Rrd^QcnZ, Re, Rrd^QcsZ, Re, Re, Re^Ii, Re^Ii, Re^Ii, Rrd^QcsZ, Re, Rrd^QcsZ, Rrd^QcsZ, Rrd^QcnZ, Uu, Rrd^QcsZ, Uu, Rrd^QcsZ, Rrd^QcsZ, Xu, Xu, Xu
Xu, Xu, Re, Re^Ii, Re, Xu, Xu, Xu, Xu, Qxu, Qxu, Qxu, Qxu, Qxu, Qxu, Rrd^QcsZ, Qxu, Rrd^QcnZ, Rrd^QcnZ, Re, Rrd^QcsZ, Rrd^QcsZ, Qxu, Rrd^QcsZ, Qxu, Qxu, Qxu, Rrd^QcsZ, Qxu, Rrd^QcsZ, Qxu, Qxu, Xu, Xu, Xu
Xu, Xu, Re, Re^Ii, Re, Xu, Xu, Xu, Xu, Xu, Qxu, Qxu, Qxu, Qxu, Qxu, Qxu, Qxu, Qxu, Qxu, Rrd^QcsZ, Qxu, Qxu, Qxu, Qxu, Qxu, Qxu, Qxu, Qxu, Qxu, Qxu, Qxu, Qxu, Qxu, Xu, Xu
Xu, Xu, Re, Re^Ii, Re, Xu, Xu, Xu, Xu, Xu, Rrd^QcnZ, Rrd^QcnZ, Rrd^QcsZ, Qxu, Qxu, Qxu, Qxu, Qxu, Qxu, Qxu, Qxu, Qxu, Qxu, Qxu, Qxu, Qxu, Qxu, Qxu, Qxu, Qxu, Qxu, Qxu, Qxu, Xu, Xu
Xu, Xu, Re, Re^Ii, Re^Ii, Re, Re, Xu, Xu, Xu, Re, Re, Re^Ii, Rrd^QcsZ, Rrd^QcsZ, Qxu, Rrd^QcnZ, Rrd^QcnZ, Rrd^QcsZ, Qxu, Qxu, Qxu, Rrd^QcnZ, Qxu, Qxu, Qxu, Qxu, Qxu, Qxu, Qxu, Qxu, Qxu, Qxu, Qxu, Xu
Xu, Xu, Xu, Re, Re, Re^Ii, Re^Ii, Re, Re, Re, Re^Ii, Re^Ii, Re, Re^Ii, Re^Ii, Rrd^QcnZ, Re, Re, Re, Rrd^QcsZ, Rrd^QcnZ, Rrd^QcnZ, Re, Rrd^QcsZ, Rrd^QcsZ, Qxu, Qxu, Qxu, Qxu, Qxu, Qxu, Qxu, Qxu, Qxu, Qxu
Xu, Xu, Xu, Xu, Xu, Re, Re, Re^Ii, Re^Ii, Re^Ii, Rrd^QcsZ, Rrd^QcsZ, Rrd^QcnZ, Re, Re, Re^Ii, Re^Ii, Re^Ii, Re^Ii, Re, Re, Re, Re^Ii, Re^Ii, Re^Ii, Rrd^QcsZ, Rrd^QcsZ, Qxu, Qxu, Qxu, Qxu, Qxu, Qxu, Qxu, Qxu
Xu, Xu, Xu, Xu, Xu, Rrd^QcnZ, Rrd^QcnZ, Re, Rrd^QcsZ, Rrd^QcsZ, Qxu, Qxu, Qxu, Rrd^QcnZ, Rrd^QcnZ, Re, Rrd^QcsZ, Rrd^QcsZ, Rrd^QcnZ, Re^Ii, Re^Ii, Re^Ii, Re, Re, Re, Re^Ii, Re^Ii, Rrd^QcsZ, Rrd^QcsZ, Qxu, Qxu, Qxu, Qxu, Qxu, Qxu
Xu, Xu, Xu, Xu, Qxu, Qxu, Qxu, Rrd^QcsZ, Qxu, Qxu, Qxu, Qxu, Qxu, Qxu, Qxu, Rrd^QcsZ, Qxu, Qxu, Qxu, Rrd^QcnZ, Rrd^QcnZ, Re, Rrd^QcsZ, Rrd^QcsZ, Rrd^QcnZ, Re, Re^Ii, Re, Re, Rrd^QcsZ, Qxu, Qxu, Xu, Xu, Xu
Xu, Xu, Xu, Qxu, Qxu, Qxu, Qxu, Qxu, Qxu, Qxu, Qxu, Qxu, Qxu, Qxu, Qxu, Qxu, Qxu, Qxu, Qxu, Qxu, Qxu, Rrd^QcsZ, Qxu, Qxu, Qxu, Rrd^QcnZ, Rrd^QcnZ, Re^Ii, Re^Ii, Rrd^QcsZ, Rrd^QcsZ, Qxu, Xu, Xu, Xu
Xu, Xu, Xu, Qxu, Qxu, Qxu, Qxu, Qxu, Qxu, Qxu, Qxu, Qxu, Qxu, Qxu, Qxu, Qxu, Qxu, Qxu, Qxu, Qxu, Qxu, Qxu, Qxu, Qxu, Qxu, Qxu, Xu, Re, Re, Re^Ii, Re, Xu, Xu, Xu, Xu
Xu, Xu, Qxu, Qxu, Qxu, Qxu, Qxu, Qxu, Qxu, Qxu, Qxu, Qxu, Qxu, Qxu, Qxu, Qxu, Qxu, Qxu, Qxu, Qxu, Qxu, Qxu, Qxu, Qxu, Qxu, Qxu, Xu, Xu, Re, Re^Ii, Re, Xu, Xu, Xu, Xu
Xu, Xu, Qxu, Qxu, Qxu, Qxu, Qxu, Qxu, Qxu, Qxu, Qxu, Qxu, Qxu, Qxu, Qxu, Qxu, Qxu, Qxu, Qxu, Qxu, Qxu, Qxu, Qxu, Qxu, Qxu, Xu, Xu, Xu, Re, Re^Ii, Re^Ii, Re, Xu, Xu, Xu
Xu, Qxu, Qxu, Qxu, Qxu, Qxu, Qxu, Qxu, Qxu, Qxu, Qxu, Qxu, Qxu, Qxu, Qxu, Qxu, Qxu, Qxu, Qxu, Qxu, Qxu, Qxu, Qxu, Qxu, Qxu, Xu, Xu, Xu, Xu, Re, Re^Ii, Re, Xu, Xu, Xu
Qxu, Qxu, Qxu, Qxu, Qxu, Qxu, Qxu, Qxu, Qxu, Qxu, Qxu, Qxu, Qxu, Qxu, Qxu, Qxu, Qxu, Qxu, Qxu, Qxu, Qxu, Qxu, Qxu, Qxu, Xu, Xu, Xu, Xu, Xu, Re, Re^Ii, Re, Xu, Xu, Xu
Qxu, Qxu, Qxu, Qxu, Qxu, Qxu, Qxu, Qxu, Qxu, Qxu, Qxu, Qxu, Qxu, Qxu, Qxu, Qxu, Qxu, Qxu, Qxu, Qxu, Qxu, Qxu, Qxu, Qxu, Xu, Xu, Xu, Xu, Xu, Re, Re^Ii, Re, Xu, Xu, Xu
Xu, Qxu, Qxu, Qxu, Qxu, Qxu, Qxu, Qxu, Qxu, Qxu, Qxu, Qxu, Qxu, Qxu, Qxu, Qxu, Qxu, Qxu, Rrd^QcnZ, Qxu, Qxu, Qxu, Rrd^QcnZ, Rrd^QcnZ, Rrd^QcsZ, Xu, Xu, Xu, Xu, Re, Re^Ii, Re, Xu, Xu, Xu
Xu, Xu, Qxu, Qxu, Qxu, Qxu, Qxu, Qxu, Qxu, Qxu, Qxu, Qxu, Qxu, Qxu, Rrd^QcnZ, Qxu, Rrd^QcnZ, Rrd^QcnZ, Re, Rrd^QcsZ, Rrd^QcnZ, Rrd^QcnZ, Re^Ii, Re, Re, Xu, Xu, Xu, Re, Re, Re^Ii, Re, Xu, Xu, Xu
Xu, Xu, Xu, Qxu, Qxu, Qxu, Qxu, Qxu, Qxu, Qxu, Qxu, Qxu, Rrd^QcnZ, Rrd^QcnZ, Re, Rrd^QcnZ, Re, Re, Re^Ii, Re, Re^Ii, Re^Ii, Re, Re^Ii, Re^Ii, Re, Re, Re, Re^Ii, Re^Ii, Re, Re, Xu, Xu, Xu
Xu, Xu, Xu, Xu, Rrd^QcnZ, Rrd^QcnZ, Rrd^QcsZ, Qxu, Qxu, Qxu, Rrd^QcnZ, Rrd^QcnZ, Re, Re, Re^Ii, Re, Re^Ii, Re^Ii, Re, Re^Ii, Re, Re, Rrd^QcsZ, Re, Re, Re^Ii, Re^Ii, Re^Ii, Rrd^QcsZ, Re, Xu, Xu, Xu, Xu, Xu
Xu, Xu, Xu, Xu, Re, Re, Re^Ii, Rrd^QcsZ, Rrd^QcnZ, Rrd^QcnZ, Re, Re, Re^Ii, Re^Ii, Re, Re^Ii, Rrd^QcsZ, Rrd^QcsZ, Rrd^QcnZ, Re, Rrd^QcsZ, Rrd^QcsZ, Qxu, Rrd^QcnZ, Rrd^QcnZ, Re, Rrd^QcsZ, Rrd^QcsZ, Qxu, Xu, Xu, Xu, Xu, Xu, Xu
Xu, Xu, Re, Re, Re^Ii, Re^Ii, Re, Re^Ii, Re^Ii, Re, Re^Ii, Re^Ii, Re, Re, Rrd^QcsZ, Rrd^QcsZ, Qxu, Qxu, Qxu, Rrd^QcsZ, Qxu, Qxu, Qxu, Qxu, Qxu, Rrd^QcsZ, Qxu, Qxu, Qxu, Qxu, Qxu, Xu, Qxu, Xu, Qxu
Xu, Xu, Re, Re^Ii, Re, Re, Xu, Re, Re, Re^Ii, Rrd^QcsZ, Rrd^QcsZ, Rrd^QcsZ, Rrd^QcsZ, Qxu, Qxu, Qxu, Qxu, Qxu, Qxu, Qxu, Qxu, Qxu, Qxu, Qxu, Qxu, Qxu, Qxu, Qxu, Qxu, Qxu, Qxu, Qxu, Qxu, Qxu
Xu, Xu, Re, Re^Ii, Re, Xu, Xu, Xu, Rrd^QcsZ, Rrd^QcsZ, Qxu, Qxu, Qxu, Qxu, Qxu, Qxu, Qxu, Qxu, Qxu, Qxu, Qxu, Qxu, Qxu, Qxu, Qxu, Qxu, Qxu, Qxu, Qxu, Qxu, Qxu, Qxu, Qxu, Qxu, Qxu
Xu, Xu, Re, Re^Ii, Re, Xu, Xu, Xu, Xu, Qxu, Qxu, Qxu, Qxu, Qxu, Qxu, Qxu, Qxu, Qxu, Qxu, Qxu, Qxu, Qxu, Qxu, Qxu, Qxu, Qxu, Qxu, Qxu, Qxu, Qxu, Qxu, Qxu, Qxu, Qxu, Qxu
Xu, Xu, Re, Re^Ii, Re, Xu, Xu, Xu, Xu, Qxu, Qxu, Qxu, Qxu, Qxu, Qxu, Qxu, Qxu, Qxu, Qxu, Qxu, Qxu, Qxu, Qxu, Qxu, Qxu, Qxu, Qxu, Qxu, Qxu, Qxu, Qxu, Qxu, Qxu, Qxu, Qxu
Xu, Xu, Re, Re^Ii, Re, Xu, Xu, Xu, Xu, Qxu, Qxu, Qxu, Qxu, Qxu, Rrd^QcnZ, Rrd^QcnZ, Rrd^QcsZ, Qxu, Qxu, Qxu, Qxu, Qxu, Qxu, Qxu, Qxu, Qxu, Qxu, Qxu, Qxu, Qxu, Qxu, Qxu, Qxu, Qxu, Qxu
Xu, Xu, Re, Re^Ii, Re^Ii, Re, Re, Xu, Rrd^QcsZ, Qxu, Qxu, Qxu, Rrd^QcnZ, Rrd^QcnZ, Re, Re, Re, Rrd^QcsZ, Rrd^QcsZ, Qxu, Rrd^QcnZ, Qxu, Qxu, Qxu, Qxu, Qxu, Qxu, Qxu, Qxu, Qxu, Qxu, Qxu, Qxu, Qxu, Qxu
Xu, Xu, Xu, Re, Re, Re^Ii, Re^Ii, Re, Re, Rrd^QcsZ, Rrd^QcnZ, Rrd^QcnZ, Re^Ii, Re, Re^Ii, Re^Ii, Re^Ii, Re, Re^Ii, Rrd^QcnZ, Re, Rrd^QcsZ, Rrd^QcnZ, Rrd^QcnZ, Rrd^QcsZ, Qxu, Rrd^QcnZ, Qxu, Qxu, Qxu, Qxu, Qxu, Xu, Qxu, Xu
Xu, Xu, Xu, Xu, Rrd^QcsZ, Rrd^QcsZ, Rrd^QcnZ, Re^Ii, Re^Ii, Re, Re^Ii, Re^Ii, Re, Re^Ii, Rrd^QcsZ, Rrd^QcsZ, Rrd^QcnZ, Re^Ii, Re, Re^Ii, Re^Ii, Re, Re, Re, Re^Ii, Rrd^QcnZ, Re, Rrd^QcsZ, Rrd^QcsZ, Qxu, Qxu, Xu, Xu, Xu, Xu
Xu, Xu, Xu, Xu, Qxu, Qxu, Qxu, Rrd^QcnZ, Rrd^QcnZ, Re^Ii, Re, Re, Rrd^QcsZ, Rrd^QcsZ, Qxu, Qxu, Qxu, Rrd^QcnZ, Rrd^QcnZ, Re, Rrd^QcsZ, Re^Ii, Re^Ii, Re^Ii, Re, Re^Ii, Re^Ii, Re, Re, Rrd^QcsZ, Rrd^QcsZ, Xu, Xu, Xu, Xu
Xu, Xu, Qxu, Qxu, Qxu, Qxu, Qxu, Qxu, Rrd^QcnZ, Re^Ii, Re, Rrd^QcsZ, Qxu, Qxu, Qxu, Qxu, Qxu, Qxu, Qxu, Rrd^QcsZ, Qxu, Rrd^QcnZ, Rrd^QcsZ, Rrd^QcsZ, Rrd^QcnZ, Re, Rrd^QcsZ, Re^Ii, Re^Ii, Re, Re, Rrd^QcsZ, Xu, Xu, Xu
Xu, Xu, Qxu, Qxu, Qxu, Qxu, Qxu, Qxu, Rrd^QcnZ, Re^Ii, Re, Rrd^QcsZ, Qxu, Qxu, Qxu, Qxu, Qxu, Qxu, Qxu, Qxu, Qxu, Qxu, Qxu, Qxu, Qxu, Rrd^QcsZ, Qxu, Rrd^QcnZ, Rrd^QcnZ, Re^Ii, Re, Rrd^QcsZ, Xu, Xu, Xu
Xu, Xu, Xu, Qxu, Qxu, Qxu, Rrd^QcnZ, Rrd^QcnZ, Re^Ii, Re^Ii, Re, Rrd^QcsZ, Qxu, Qxu, Qxu, Qxu, Xu, Xu, Qxu, Qxu, Qxu, Qxu, Xu, Qxu, Qxu, Qxu, Qxu, Qxu, Qxu, Re^Ii, Qxu, Rrd^QcsZ, Xu, Xu, Xu
Xu, Xu, Xu, Qxu, Qxu, Rrd^QcnZ, Re, Re^Ii, Re, Re, Rrd^QcsZ, Rrd^QcsZ, Xu, Qxu, Qxu, Qxu, Xu, Xu, Xu, Qxu, Xu, Xu, Xu, Xu, Xu, Xu, Xu, Qxu, Qxu, Qxu, Qxu, Qxu, Xu, Xu, Xu
Xu, Xu, Xu, Qxu, Qxu, Rrd^QcnZ, Re, Re^Ii, Re, Rrd^QcsZ, Qxu, Xu, Xu, Xu, Xu, Qxu, Xu, Xu, Xu, Xu, Xu, Xu, Xu, Xu, Xu, Xu, Qxu, Qxu, Qxu, Qxu, Qxu, Qxu, Qxu, Xu, Xu
Xu, Xu, Xu, Xu, Qxu, Rrd^QcnZ, Rrd^QcnZ, Re^Ii, Qxu, Qxu, Qxu, Qxu, Qxu, Xu, Xu, Xu, Xu, Xu, Xu, Xu, Xu, Xu, Xu, Xu, Qxu, Qxu, Qxu, Qxu, Qxu, Qxu, Qxu, Qxu, Qxu, Xu, Xu
Xu, Xu, Xu, Xu, Xu, Qxu, Qxu, Qxu, Qxu, Qxu, Qxu, Qxu, Qxu, Qxu, Qxu, Xu, Xu, Xu, Xu, Xu, Xu, Xu, Xu, Xu, Qxu, Qxu, Qxu, Qxu, Qxu, Qxu, Qxu, Qxu, Xu, Xu, Xu
Xu, Xu, Xu, Xu, Xu, Qxu, Qxu, Qxu, Qxu, Qxu, Qxu, Qxu, Qxu, Qxu, Qxu, Xu, Xu, Xu, Xu, Xu, Xu, Xu, Xu, Qxu, Qxu, Qxu, Qxu, Qxu, Qxu, Qxu, Qxu, Qxu, Xu, Xu, Xu
Xu, Xu, Xu, Xu, Xu, Qxu, Qxu, Qxu, Qxu, Qxu, Qxu, Qxu, Qxu, Qxu, Qxu, Qxu, Xu, Xu, Xu, Xu, Xu, Xu, Xu, Qxu, Qxu, Qxu, Qxu, Qxu, Qxu, Qxu, Qxu, Qxu, Xu, Xu, Xu
Xu, Xu, Xu, Xu, Xu, Qxu, Qxu, Qxu, Qxu, Qxu, Qxu, Qxu, Qxu, Qxu, Qxu, Qxu, Xu, Xu, Xu, Xu, Xu, Xu, Xu, Qxu, Qxu, Qxu, Qxu, Qxu, Qxu, Qxu, Qxu, Qxu, Xu, Xu, Xu
Xu, Xu, Xu, Xu, Xu, Qxu, Qxu, Qxu, Qxu, Qxu, Qxu, Qxu, Qxu, Qxu, Qxu, Qxu, Qxu, Xu, Xu, Xu, Qxu, Xu, Qxu, Qxu, Qxu, Qxu, Qxu, Qxu, Qxu, Qxu, Qxu, Xu, Xu, Xu, Xu
Xu, Xu, Xu, Xu, Xu, Xu, Xu, Qxu, Qxu, Qxu, Qxu, Qxu, Qxu, Qxu, Qxu, Qxu, Qxu, Qxu, Qxu, Qxu, Qxu, Qxu, Qxu, Qxu, Qxu, Qxu, Qxu, Qxu, Qxu, Qxu, Xu, Xu, Xu, Xu, Xu
Xu, Xu, Xu, Xu, Xu, Xu, Xu, Xu, Xu, Xu, Xu, Qxu, Xu, Qxu, Qxu, Qxu, Qxu, Qxu, Qxu, Qxu, Qxu, Qxu, Qxu, Qxu, Qxu, Qxu, Qxu, Qxu, Xu, Xu, Xu, Xu, Xu, Xu, Xu
Xu, Xu, Xu, Xu, Xu, Xu, Xu, Xu, Xu, Xu, Xu, Xu, Xu, Xu, Xu, Qxu, Ur, Qxu, Qxu, Qxu, Ur, Qxu, Qxu, Qxu, Ur, Qxu, Xu, Xu, Xu, Xu, Xu, Xu, Xu, Xu, Xu
Xu, Xu, Xu, Xu, Xu, Xu, Xu, Xu, Xu, Xu, Xu, Xu, Xu, Xu, Xu, Ur, Ur, Ur, Ur, Ur, Ur, Ur, Ur, Ur, Ur, Ur, Xu, Xu, Xu, Xu, Xu, Xu, Xu, Xu, Xu
Xu, Xu, Xu, Xu, Xu, Xu, Xu, Xu, Xu, Xu, Xu, Xu, Xu, Xu, Xu, Ur, Ur, Ur, Ur, Ur, Ur, Ur, Ur, Ur, Ur, Ur, Xu, Xu, Xu, Xu, Xu, Xu, Xu, Xu, Xu
