Xu, Xu, Xu, Xu, Xu, Xu, Xu, Xu, Qxu, Qxu, Qxu, Qxu, Qxu, Qxu, Qxu, Qxu, Qxu, Qxu, Qxu, Qxu, Qxu, Qxu, Qxu, Xu, Xu, Xu, Xu, Xu, Xu, Xu, Xu, Xu, Xu, Xu, Xu
Xu, Xu, Xu, Xu, Qxu, Qxu, Qxu, Qxu, Qxu, Qxu, Qxu, Qxu, Qxu, Qxu, Qxu, Qxu, Qxu, Qxu, Qxu, Qxu, Qxu, Qxu, Qxu, Qxu, Qxu, Xu, Xu, Xu, Xu, Xu, Xu, Xu, Xu, Xu, Xoa
Xu, Xu, Qxu, Qxu, Qxu, Qxu, Qxu, Qxu, Qxu, Qxu, Qxu, Qxu, Qxu, Qxu, Qxu, Qxu, Qxu, Qxu, Qxu, Qxu, Qxu, Qxu, Qxu, Qxu, Qxu, Xu, Xu, Xu, Xu, Xu, Xu, Xu, Xoa, Xoa, Xoa
Xu, Xu, Qxu, Qxu, Qxu, Qxu, Qxu, Qxu, Qxu, Qxu, Uh^QcnZ, Qxu, Qxu, Qxu, Qxu, Qxu, Qxu, Qxu, Qxu, Qxu, Qxu, Qxu, Qxu, Qxu, Qxu, Qxu, Xu, Xu, Xu, Xu, Xoa, Xoa, Xoa, Xoa, Uu
Xu, Xu, Qxu, Qxu, Qxu, Qxu, Uh^QcnZ, Uh^QcnZ, Uh^QcnZ, Uh^QcnZ, Re, Uh^QcsZ, Uh^QcsZ, Qxu, Qxu, Qxu, Qxu, Qxu, Qxu, Qxu, Qxu, Qxu, Qxu, Qxu, Qxu, Qxu, Xu, Xu, Xoa, Xoa, Xoa, Xoa, 1 Isa, Uu, Isa
Xu, Xu, Xu, Qxu, Uh^QcnZ, Uh^QcnZ, Re, Re, Re, Re, Re^Ii, Re, Re, Uh^QcsZ, Uh^QcsZ, Qxu, Qxu, Qxu, Qxu, Qxu, Qxu, Qxu, Qxu, Qxu, Uh^QcnZ, Uh^QcnZ, Uu, Xoa, Xoa, Xoa, Isa, Isa, Uu, Isa, Xoa
Xu, Xu, Xu, Xu, Re, Re, Re^Ii, Re^Ii, Re^Ii, Re^Ii, Re, Re^Ii, Re^Ii, Re, Uh^QcsZ, Qxu, Qxu, Qxu, Qxu, Qxu, Qxu, Qxu, Qxu, Qxu, Uh^QcnZ, Uu, Ur, Ur, Uu, Uu, Isa, Uu, Xoa, Xoa, Xoa
Xu, Xu, Re, Re, Re^Ii, Re^Ii, Re, Re, Uh^QcsZ, Uh^QcsZ, Uh^QcnZ, Re, Re, Re^Ii, Re, Uh^QcsZ, Uh^QcsZ, Qxu, Uh^QcnZ, Qxu, Qxu, Qxu, Uh^QcnZ, Uh^QcnZ, Uu, Uu, Ur, Ur, Ur, Isa, Ur, Xoa, Xoa, Xoa, Xoa
Xu, Xu, Re, Re^Ii, Re, Re, Xu, Uh^QcsZ, Qxu, Qxu, Qxu, Uh^QcnZ, Uh^QcnZ, Re^Ii, Re^Ii, Re, Re, Uh^QcnZ, Re, Uh^QcsZ, Uh^QcnZ, Uh^QcnZ, Re, Re, Uu, Ur, Ur, Ur, Ur, Ur, Ur, Uu, Xu, Xoa, Xoa
Xu, Xu, Xu, Re^Ii, Re, Xu, Xu, Xu, Qxu, Qxu, Qxu, Qxu, Uh^QcnZ, Re, Re, Re^Ii, Re^Ii, Re^Ii, Re^Ii, Re, Re, Re, Re^Ii, Re^Ii, Re, Uu, Uu, Ur, Uu, Ur, Uu, Uu, Xu, Xu, Xu
Xu, Xu, Xu, Re^Ii, Re, Xu, Xu, Xu, Xu, Qxu, Qxu, Qxu, Qxu, Uh^QcnZ, Uh^QcnZ, Re, Uh^QcsZ, Re, Re, Re^Ii, Re^Ii, Re^Ii, Uh^QcsZ, Re, Uh^QcsZ, Uh^QcsZ, Uh^QcnZ, Uu, Uh^QcsZ, Uu, Uh^QcsZ, Uh^QcsZ, Xu, Xu, Xu
Xu, Xu, Re, Re^Ii, Re, Xu, Xu, Xu, Xu, Qxu, Qxu, Qxu, Qxu, Qxu, Qxu, Uh^QcsZ, Qxu, Uh^QcnZ, Uh^QcnZ, Re, Uh^QcsZ, Uh^QcsZ, Qxu, Uh^QcsZ, Uu, Uh, Uu, Uh^QcsZ, Uh, Uh^QcsZ, Qxu, Qxu, Xu, Xu, Xu
Xu, Xu, Re, Re^Ii, Re, Xu, Xu, Xu, Xu, Xu, Qxu, Qxu, Qxu, Qxu, Qxu, Qxu, Qxu, Qxu, Qxu, Uh^QcsZ, Qxu, Qxu, Qxu, Qxu, Qxu, Uu, Qxu, Uu, Uu, Uu, Qxu, Qxu, Qxu, Xu, Xu
Xu, Xu, Re, Re^Ii, Re, Xu, Xu, Xu, Xu, Xu, Uh^QcnZ, Uh^QcnZ, Uh^QcsZ, Qxu, Qxu, Qxu, Qxu, Qxu, Qxu, Qxu, Qxu, Qxu, Qxu, Qxu, Qxu, Qxu, Qxu, Qxu, Qxu, Qxu, Qxu, Qxu, Qxu, Xu, Xu
Xu, Xu, Re, Re^Ii, Re^Ii, Re, Re, Xu, Xu, Xu, Re, Re, Re^Ii, Uh^QcsZ, Uh^QcsZ, Qxu, Uh^QcnZ, Uh^QcnZ, Uh^QcsZ, Qxu, Qxu, Qxu, Uh^QcnZ, Qxu, Qxu, Qxu, Qxu, Qxu, Qxu, Qxu, Qxu, Qxu, Qxu, Qxu, Xu
Xu, Xu, Xu, Re, Re, Re^Ii, Re^Ii, Re, Re, Re, Re^Ii, Re^Ii, Re, Re^Ii, Re^Ii, Uh^QcnZ, Re, Re, Re, Uh^QcsZ, Uh^QcnZ, Uh^QcnZ, Re, Uh^QcsZ, Uh^QcsZ, Qxu, Qxu, Qxu, Qxu, Qxu, Qxu, Qxu, Qxu, Qxu, Qxu
Xu, Xu, Xu, Xu, Xu, Re, Re, Re^Ii, Re^Ii, Re^Ii, Uh^QcsZ, Uh^QcsZ, Uh^QcnZ, Re, Re, Re^Ii, Re^Ii, Re^Ii, Re^Ii, Re, Re, Re, Re^Ii, Re^Ii, Re^Ii, Uh^QcsZ, Uh^QcsZ, Qxu, Qxu, Qxu, Qxu, Qxu, Qxu, Qxu, Qxu
Xu, Xu, Xu, Xu, Xu, Uh^QcnZ, Uh^QcnZ, Re, Uh^QcsZ, Uh^QcsZ, Qxu, Qxu, Qxu, Uh^QcnZ, Uh^QcnZ, Re, Uh^QcsZ, Uh^QcsZ, Uh^QcnZ, Re^Ii, Re^Ii, Re^Ii, Re, Re, Re, Re^Ii, Re^Ii, Uh^QcsZ, Uh^QcsZ, Qxu, Qxu, Qxu, Qxu, Qxu, Qxu
Xu, Xu, Xu, Xu, Qxu, Qxu, Qxu, Uh^QcsZ, Qxu, Qxu, Qxu, Qxu, Qxu, Qxu, Qxu, Uh^QcsZ, Qxu, Qxu, Qxu, Uh^QcnZ, Uh^QcnZ, Re, Uh^QcsZ, Uh^QcsZ, Uh^QcnZ, Re, Re^Ii, Re, Re, Uh^QcsZ, Qxu, Qxu, Xu, Xu, Xu
Xu, Xu, Xu, Xu, Qxu, Qxu, Qxu, Qxu, Qxu, Qxu, Qxu, Qxu, Qxu, Qxu, Qxu, Qxu, Qxu, Qxu, Qxu, Qxu, Qxu, Uh^QcsZ, Qxu, Qxu, Qxu, Uh^QcnZ, Uh^QcnZ, Re^Ii, Re^Ii, Uh^QcsZ, Uh^QcsZ, Qxu, Xu, Xu, Xu
Xu, Xu, Xu, Qxu, Qxu, Qxu, Qxu, Qxu, Qxu, Qxu, Qxu, Qxu, Qxu, Qxu, Qxu, Qxu, Qxu, Qxu, Qxu, Qxu, Qxu, Qxu, Qxu, Qxu, Qxu, Qxu, Xu, Re, Re, Re^Ii, Re, Xu, Xu, Xu, Xu
Xu, Xu, Qxu, Qxu, Qxu, Qxu, Qxu, Qxu, Qxu, Qxu, Qxu, Qxu, Qxu, Qxu, Qxu, Qxu, Qxu, Qxu, Qxu, Qxu, Qxu, Qxu, Qxu, Qxu, Qxu, Qxu, Xu, Xu, Re, Re^Ii, Re, Xu, Xu, Xu, Xu
Xu, Xu, Qxu, Qxu, Qxu, Qxu, Qxu, Qxu, Qxu, Qxu, Qxu, Qxu, Qxu, Qxu, Qxu, Qxu, Qxu, Qxu, Qxu, Qxu, Qxu, Qxu, Qxu, Qxu, Qxu, Xu, Xu, Xu, Re, Re^Ii, Re^Ii, Re, Xu, Xu, Xu
Xu, Xu, Xu, Qxu, Qxu, Qxu, Qxu, Qxu, Qxu, Qxu, Qxu, Qxu, Qxu, Qxu, Qxu, Qxu, Qxu, Qxu, Qxu, Qxu, Qxu, Qxu, Qxu, Qxu, Qxu, Xu, Xu, Xu, Xu, Re, Re^Ii, Re, Xu, Xu, Xu
Xu, Xu, Xu, Qxu, Qxu, Qxu, Qxu, Qxu, Qxu, Qxu, Qxu, Qxu, Qxu, Qxu, Qxu, Qxu, Qxu, Qxu, Qxu, Qxu, Qxu, Qxu, Qxu, Qxu, Xu, Xu, Xu, Xu, Xu, Re, Re^Ii, Re, Xu, Xu, Xu
Xu, Xu, Xu, Xu, Qxu, Qxu, Qxu, Qxu, Qxu, Qxu, Qxu, Qxu, Qxu, Qxu, Qxu, Qxu, Qxu, Qxu, Qxu, Qxu, Qxu, Qxu, Qxu, Qxu, Xu, Xu, Xu, Xu, Xu, Re, Re^Ii, Re, Xu, Xu, Xu
Xu, Xu, Xu, Xu, Qxu, Qxu, Qxu, Qxu, Qxu, Qxu, Qxu, Qxu, Qxu, Qxu, Qxu, Qxu, Qxu, Qxu, Uh^QcnZ, Qxu, Qxu, Qxu, Uh^QcnZ, Uh^QcnZ, Uh^QcsZ, Xu, Xu, Xu, Xu, Re, Re^Ii, Re, Xu, Xu, Xu
Xu, Xu, Xu, Qxu, Qxu, Qxu, Qxu, Qxu, Qxu, Qxu, Qxu, Qxu, Qxu, Qxu, Uh^QcnZ, Qxu, Uh^QcnZ, Uh^QcnZ, Re, Uh^QcsZ, Uh^QcnZ, Uh^QcnZ, Re^Ii, Re, Re, Xu, Xu, Xu, Re, Re, Re^Ii, Re, Xu, Xu, Xu
Xu, Xu, Xu, Qxu, Qxu, Qxu, Qxu, Qxu, Qxu, Qxu, Qxu, Qxu, Uh^QcnZ, Uh^QcnZ, Re, Uh^QcnZ, Re, Re, Re^Ii, Re, Re^Ii, Re^Ii, Re, Re^Ii, Re^Ii, Re, Re, Re, Re^Ii, Re^Ii, Re, Re, Xu, Xu, Xu
Xu, Xu, Xu, Xu, Uh^QcnZ, Uh^QcnZ, Uh^QcsZ, Qxu, Qxu, Qxu, Uh^QcnZ, Uh^QcnZ, Re, Re, Re^Ii, Re, Re^Ii, Re^Ii, Re, Re^Ii, Re, Re, Uh^QcsZ, Re, Re, Re^Ii, Re^Ii, Re^Ii, Uh^QcsZ, Re, Xu, Xu, Xu, Xu, Xu
Xu, Xu, Xu, Xu, Re, Re, Re^Ii, Uh^QcsZ, Uh^QcnZ, Uh^QcnZ, Re, Re, Re^Ii, Re^Ii, Re, Re^Ii, Uh^QcsZ, Uh^QcsZ, Uh^QcnZ, Re, Uh^QcsZ, Uh^QcsZ, Qxu, Uh^QcnZ, Uh^QcnZ, Re, Uh^QcsZ, Uh^QcsZ, Qxu, Xu, Xu, Xu, Xu, Xu, Xu
Xu, Xu, Re, Re, Re^Ii, Re^Ii, Re, Re^Ii, Re^Ii, Re, Re^Ii, Re^Ii, Re, Re, Uh^QcsZ, Uh^QcsZ, Qxu, Qxu, Qxu, Uh^QcsZ, Qxu, Qxu, Qxu, Qxu, Qxu, Uh^QcsZ, Qxu, Qxu, Qxu, Qxu, Qxu, Xu, Qxu, Xu, Qxu
Xu, Xu, Re, Re^Ii, Re, Re, Xu, Re, Re, Re^Ii, Uh^QcsZ, Uh^QcsZ, Uh^QcsZ, Uh^QcsZ, Qxu, Qxu, Qxu, Qxu, Qxu, Qxu, Qxu, Qxu, Qxu, Qxu, Qxu, Qxu, Qxu, Qxu, Qxu, Qxu, Qxu, Qxu, Qxu, Qxu, Qxu
Xu, Xu, Re, Re^Ii, Re, Xu, Xu, Xu, Uh^QcsZ, Uh^QcsZ, Qxu, Qxu, Qxu, Qxu, Qxu, Qxu, Qxu, Qxu, Qxu, Qxu, Qxu, Qxu, Qxu, Qxu, Qxu, Qxu, Qxu, Qxu, Qxu, Qxu, Qxu, Qxu, Qxu, Qxu, Qxu
Xu, Xu, Re, Re^Ii, Re, Xu, Xu, Xu, Xu, Qxu, Qxu, Qxu, Qxu, Qxu, Qxu, Qxu, Qxu, Qxu, Qxu, Qxu, Qxu, Qxu, Qxu, Qxu, Qxu, Qxu, Qxu, Qxu, Qxu, Qxu, Qxu, Qxu, Qxu, Qxu, Qxu
Xu, Xu, Re, Re^Ii, Re, Xu, Xu, Xu, Xu, Qxu, Qxu, Qxu, Qxu, Qxu, Qxu, Qxu, Qxu, Qxu, Qxu, Qxu, Qxu, Qxu, Qxu, Qxu, Qxu, Qxu, Qxu, Qxu, Qxu, Qxu, Qxu, Qxu, Qxu, Qxu, Qxu
Xu, Xu, Re, Re^Ii, Re, Xu, Xu, Xu, Xu, Qxu, Qxu, Qxu, Qxu, Qxu, Uh^QcnZ, Uh^QcnZ, Uh^QcsZ, Qxu, Qxu, Qxu, Qxu, Qxu, Qxu, Qxu, Qxu, Qxu, Qxu, Qxu, Qxu, Qxu, Qxu, Qxu, Qxu, Qxu, Qxu
Xu, Xu, Re, Re^Ii, Re^Ii, Re, Re, Xu, Uh^QcsZ, Qxu, Qxu, Qxu, Uh^QcnZ, Uh^QcnZ, Re, Re, Re, Uh^QcsZ, Uh^QcsZ, Qxu, Uh^QcnZ, Qxu, Qxu, Qxu, Qxu, Qxu, Qxu, Qxu, Qxu, Qxu, Qxu, Qxu, Qxu, Qxu, Qxu
Xu, Xu, Xu, Re, Re, Re^Ii, Re^Ii, Re, Re, Uh^QcsZ, Uh^QcnZ, Uh^QcnZ, Re^Ii, Re, Re^Ii, Re^Ii, Re^Ii, Re, Re^Ii, Uh^QcnZ, Re, Uh^QcsZ, Uh^QcnZ, Uh^QcnZ, Uh^QcsZ, Qxu, Uh^QcnZ, Qxu, Qxu, Qxu, Qxu, Qxu, Xu, Qxu, Xu
Xu, Xu, Xu, Xu, Uh^QcsZ, Uh^QcsZ, Uh^QcnZ, Re^Ii, Re^Ii, Re, Re^Ii, Re^Ii, Re, Re^Ii, Uh^QcsZ, Uh^QcsZ, Uh^QcnZ, Re^Ii, Re, Re^Ii, Re^Ii, Re, Re, Re, Re^Ii, Uh^QcnZ, Re, Uh^QcsZ, Uh^QcsZ, Qxu, Qxu, Xu, Xu, Xu, Xu
Xu, Xu, Xu, Xu, Qxu, Qxu, Qxu, Uh^QcnZ, Uh^QcnZ, Re^Ii, Re, Re, Uh^QcsZ, Uh^QcsZ, Qxu, Qxu, Qxu, Uh^QcnZ, Uh^QcnZ, Re, Uh^QcsZ, Re^Ii, Re^Ii, Re^Ii, Re, Re^Ii, Re^Ii, Re, Re, Uh^QcsZ, Uh^QcsZ, Xu, Xu, Xu, Xu
Xu, Xu, Qxu, Qxu, Qxu, Qxu, Qxu, Qxu, Uh^QcnZ, Re^Ii, Re, Uh^QcsZ, Qxu, Qxu, Qxu, Qxu, Qxu, Qxu, Qxu, Uh^QcsZ, Qxu, Uh^QcnZ, Uh^QcsZ, Uh^QcsZ, Uh^QcnZ, Re, Uh^QcsZ, Re^Ii, Re^Ii, Re, Re, Uh^QcsZ, Xu, Xu, Xu
Xu, Xu, Qxu, Qxu, Qxu, Qxu, Qxu, Qxu, Uh^QcnZ, Re^Ii, Re, Uh^QcsZ, Qxu, Qxu, Qxu, Qxu, Qxu, Qxu, Qxu, Qxu, Qxu, Qxu, Qxu, Qxu, Qxu, Uh^QcsZ, Qxu, Uh^QcnZ, Uh^QcnZ, Re^Ii, Re, Uh^QcsZ, Xu, Xu, Xu
Xu, Xu, Xu, Qxu, Qxu, Qxu, Uh^QcnZ, Uh^QcnZ, Re^Ii, Re^Ii, Re, Uh^QcsZ, Qxu, Qxu, Qxu, Qxu, Xu, Xu, Qxu, Qxu, Qxu, Qxu, Xu, Qxu, Qxu, Qxu, Qxu, Qxu, Qxu, Re^Ii, Qxu, Uh^QcsZ, Xu, Xu, Xu
Xu, Xu, Xu, Qxu, Qxu, Uh^QcnZ, Re, Re^Ii, Re, Re, Uh^QcsZ, Uh^QcsZ, Xu, Qxu, Qxu, Qxu, Xu, Xu, Xu, Qxu, Xu, Xu, Xu, Xu, Xu, Xu, Xu, Qxu, Qxu, Qxu, Qxu, Qxu, Xu, Xu, Xu
Xu, Xu, Xu, Qxu, Qxu, Uh^QcnZ, Re, Re^Ii, Re, Uh^QcsZ, Qxu, Xu, Xu, Xu, Xu, Qxu, Xu, Xu, Xu, Xu, Xu, Xu, Xu, Xu, Xu, Xu, Qxu, Qxu, Qxu, Qxu, Qxu, Qxu, Qxu, Xu, Xu
Xu, Xu, Xu, Xu, Qxu, Uh^QcnZ, Uh^QcnZ, Re^Ii, Qxu, Qxu, Qxu, Qxu, Qxu, Xu, Xu, Xu, Xu, Xu, Xu, Xu, Xu, Xu, Xu, Xu, Qxu, Qxu, Qxu, Qxu, Qxu, Qxu, Qxu, Qxu, Qxu, Xu, Xu
Xu, Xu, Xu, Xu, Xu, Qxu, Qxu, Qxu, Qxu, Qxu, Qxu, Qxu, Qxu, Qxu, Qxu, Xu, Xu, Xu, Xu, Xu, Xu, Xu, Xu, Xu, Qxu, Qxu, Qxu, Qxu, Qxu, Qxu, Qxu, Qxu, Xu, Xu, Xu
Xu, Xu, Xu, Xu, Xu, Qxu, Qxu, Qxu, Qxu, Qxu, Qxu, Qxu, Qxu, Qxu, Qxu, Xu, Xu, Xu, Xu, Xu, Xu, Xu, Xu, Qxu, Qxu, Qxu, Qxu, Qxu, Qxu, Qxu, Qxu, Qxu, Xu, Xu, Xu
Xu, Xu, Xu, Xu, Xu, Qxu, Qxu, Qxu, Qxu, Qxu, Qxu, Qxu, Qxu, Qxu, Qxu, Qxu, Xu, Xu, Xu, Xu, Xu, Xu, Xu, Qxu, Qxu, Qxu, Qxu, Qxu, Qxu, Qxu, Qxu, Qxu, Xu, Xu, Xu
Xu, Xu, Xu, Xu, Xu, Qxu, Qxu, Qxu, Qxu, Qxu, Qxu, Qxu, Qxu, Qxu, Qxu, Qxu, Xu, Xu, Xu, Xu, Xu, Xu, Xu, Qxu, Qxu, Qxu, Qxu, Qxu, Qxu, Qxu, Qxu, Qxu, Xu, Xu, Xu
Xu, Xu, Xu, Xu, Xu, Qxu, Qxu, Qxu, Qxu, Qxu, Qxu, Qxu, Qxu, Qxu, Qxu, Qxu, Qxu, Xu, Xu, Xu, Qxu, Xu, Qxu, Qxu, Qxu, Qxu, Qxu, Qxu, Qxu, Qxu, Qxu, Xu, Xu, Xu, Xu
Xu, Xu, Xu, Xu, Xu, Xu, Xu, Qxu, Qxu, Qxu, Qxu, Qxu, Qxu, Qxu, Qxu, Qxu, Qxu, Qxu, Qxu, Qxu, Qxu, Qxu, Qxu, Qxu, Qxu, Qxu, Qxu, Qxu, Qxu, Qxu, Xu, Xu, Xu, Xu, Xu
Xu, Xu, Xu, Xu, Xu, Xu, Xu, Xu, Xu, Xu, Xu, Qxu, Xu, Qxu, Qxu, Qxu, Qxu, Qxu, Qxu, Qxu, Qxu, Qxu, Qxu, Qxu, Qxu, Qxu, Qxu, Qxu, Xu, Xu, Xu, Xu, Xu, Xu, Xu
Xu, Xu, Xu, Xu, Xu, Xu, Xu, Xu, Xu, Xu, Xu, Xu, Xu, Xu, Xu, Qxu, Ur, Qxu, Qxu, Qxu, Ur, Qxu, Qxu, Qxu, Ur, Qxu, Xu, Xu, Xu, Xu, Xu, Xu, Xu, Xu, Xu
Xu, Xu, Xu, Xu, Xu, Xu, Xu, Xu, Xu, Xu, Xu, Xu, Xu, Xu, Xu, Ur, Ur, Ur, Ur, Ur, Ur, Ur, Ur, Ur, Ur, Ur, Xu, Xu, Xu, Xu, Xu, Xu, Xu, Xu, Xu
Xu, Xu, Xu, Xu, Xu, Xu, Xu, Xu, Xu, Xu, Xu, Xu, Xu, Xu, Xu, Ur, Ur, Ur, Ur, Ur, Ur, Ur, Ur, Ur, Ur, Ur, Xu, Xu, Xu, Xu, Xu, Xu, Xu, Xu, Xu
