Wog, Wog, Wog, Wog, Wog, Wog, Wog, Wog, Wog, Wog, Wog, Wog, Wog, Wog, Wog, Wog, Wog, Wog, Wog, Wog, Wog, Wog, Wog, Wog, Wog, Wog, Wog, Wog, Wog, Wog, Wog, Wog, Wog, Wog, Wog, Wog
Wog, Wog, Wog, Wog, Wog, Wog, Wwg, Wog, Wwrg, Wwg, Wwg, Wog, Wwg, Wog, Wog, Wog, Wog, Wog, Wog, Wog, Wog, Wog, Wog, Wog, Wog, Wog, Wog, Wog, Wog, Wog, Wog, Wog, Wwg, Wog, Wog, Wog
Wog, Wog, Wwrg, Wwrg, Wwrg, Wwg, Rb, Wwrg, Tb, Tb^Tf, Tb^Tf, Wwg, Tb, Wwrg, Wwrg, Wwg, Wwg, Wog, Wwrg, Wwg, Wwg, Wog, Wwrg, Wog, Wog, Wog, Wwrg, Wog, Wwg, Wwg, Wwrg, Wwrg, Tb, Wwg, Wwg, Wog
Wog, Wwg, Uh, Tb^Tf, Tb^Tf, Uh, Uh, Rb, Uh, Uh^Tf, Sm, Tb, Uh^Tf, Tb, Sm, Sm, Sm, Wwrg, Sm, Sm, Uh, Wwrg, Tb, Wwg, Wwg, Wwg, Rb^Edb, Wwrg, Tb, Tb^Tf, Uh^Tf, Uh, Sm^Em, Tb^Tf, Xu, Xu
Xu, Wwg, Sm, Uh^Tf, Tb, Uu, Uu, Sm, Sm^Em, Sm, Tb, Uh, Uh^Tf, Tb^Tf, Wwg^Edb, Tb, Tb^Tf, Tb, Tb, Uh^Tf, Uh^Tf, Sm, Tb, Tb, Uh^Tf, Tb^Tf, Wwg^Edb, Rb^Edb, Rb^Edb, Tb^Tf, Uu^Edb, Uh, Tb, Sm^Em, Xu, Xu
Xu, Xu, Sm^Em, Tb^Tf, Tb, Uu, Sm, Sm^Em, Tb, Sm^Em, Sm, Sm, Tb, Wwg^Edb, Sm^Em, Tb^Tf, Sm^Em, Tb^Tf, Tb, Uu, Sm^Em, Sm, Sm, Sm, Uh, Uh^Tf, Tb, Wwg^Edb, Rb^Edb, Sm^Edb, Uu^Edb, Uu^Edb, Tb^Tf, Uu^Edb, Xu, Xu
Xu, Xu, Xu, Sm, Uh^Tf, Tb^Tf, Wwg^Es, Tb, Tb^Tf, Tb, Sm, Tb^Tf, Wwg^Edb, Wwg^Edb, Sm^Edb, Sm, Uu^Edb, Sm^Em, Tb, Uu^Edb, Uu^Edb, Tb^Tf, Tb^Tf, Uh^Tf, Uu, Sm, Sm, Wwg^Edb, Sm, Sm^Em, Sm^Em, Tb^Tf, Uu, Tb, Xu, Xu
Xu, Xu, Xu, Uh^Edb, Uh^Edb, Tb^Tf, Wwg^Es, Tb^Tf, Uh^Tf, Uu, Uu, Sm^Em, Tb^Tf, Tb, Sm, Uu^Edb, Sm^Edb, Tb, Tb^Tf, Uu^Edb, Tb, Sm, Sm, Tb, Tb^Tf, Sm^Em, Tb, Tb, Uh, Uh, Sm, Uu^Edb, Uu, Xu, Xu, Xu
Xu, Xu, Sm^Edb, Sm^Edb, Tb, Wwg^Es, Sm, Uu, Uh, Uh, Sm, Sm^Em, Tb, Uh, Uh^Tf, Tb^Tf, Sm^Em, Tb^Tf, Uh^Tf, Tb, Sm^Edb, Tb, Wwg^Edb, Tb, Sm, Sm, Sm^Em, Uu^Edb, Uu^Edb, Uh^Tf, Tb^Tf, Sm, Wwg, Xu, Xu, Xu
Xu, Xu, Uh^Tf, Tb^Tf, Wwg^Es, Wwg^Es, Wwg^Es, Sm, Wwg^Es, Tb^Tf, Rb^Edb, Sm^Em, Sm, Uh, Wwg^Es, Tb^Tf, Uh^Tf, Uh, Uh, Tb, Sm^Edb, Wwg^Edb, Sm^Edb, Wwg^Edb, Tb^Tf, Sm^Em, Wwg^Es, Sm, Tb, Tb^Tf, Sm^Em, Wwrg, Wog, Xu, Wo, Wo
Xu, Xu, Xu, Wwg^Es, Uh^Tf, Uh, Sm, Wwg^Es, Tb, Rb, Sm, Rb^Edb, Wwg^Es, Wwg^Es, Wwg^Es, Tb, Tb, Uh, Wwg^Es, Tb^Tf, Tb, Tb, Uh, Sm, Tb, Wwg^Es, Tb, Rb^Edb, Rb^Edb, Sm, Xu, Wwrg, Xu, Wog, Xu, Xu
Xu, Xu, Xu, Wwg^Es, Tb^Tf, Sm, Uu, Tb, Uh, Tb^Tf, Uu, Sm^Em, Sm, Tb^Tf, Uh^Tf, Uh, Tb, Tb^Tf, Uh^Tf, Wwg^Es, Tb, Uh, Uh^Tf, Tb, Wwg^Es, Wwg^Es, Tb^Tf, Tb^Tf, Uh^Tf, Rb, Xu, Xu, Xu, Xu, Xu, Xu
Xu, Xu, Xu, Sm, Sm^Em, Tb, Tb, Tb^Tf, Uh^Tf, Uh, Tb^Tf, Sm^Em, Tb^Tf, Tb^Tf, Uu, Uh, Tb, Uh^Tf, Tb^Tf, Wwg^Es, Sm, Uh^Tf, Tb^Tf, Sm^Em, Rb, Tb, Uu, Sm, Uh, Uh, Uu^Edb, Xu, Xu, Xu, Xu, Xu
Xu, Xu, Xu, Sm^Em, Rb^Edb, Tb, Sm, Uh^Tf, Uh, Tb, Tb, Wwg^Es, Wwg^Es, Uu, Sm^Edb, Rb^Edb, Rb, Sm, Tb, Tb, Wwg^Es, Sm^Em, Tb^Tf, Tb, Rb^Edb, Uu^Edb, Uh^Tf, Sm^Em, Tb^Tf, Sm, Sm^Em, Xu, Xu, Xu, Qxu, Qxu
Xu, Xu, Wog, Wwrg, Wwg^Es, Rb^Edb, Wwg^Es, Sm^Em, Tb, Tb, Uh, Uu, Wwg^Es, Sm, Sm^Em, Sm^Edb, Tb, Sm^Em, Rb^Edb, Rb^Edb, Sm^Es, Wwg^Es, Wwg^Es, Rb^Edb, Sm^Em, Uh, Uh^Tf, Tb, Tb^Tf, Tb^Tf, Sm, Xu, Xu, Qxu, Ur, Qxu
Wog, Wog, Xu, Wog, Uu^Tf, Uh, Ur, Wwg^Es, Sm, Tb^Tf, Uh^Tf, Uh, Uu, Tb, Uh^Tf, Uh, Uu, Tb, Tb, Sm^Em, Uu, Uh, Tb, Sm, Tb, Tb^Tf, Sm^Em, Uu, Uu^Edb, Tb, Uu^Tf, Xu, Uh, Uu^Tf, Uu, Ur
Xu, Xu, Xu, Xu, Uu, Ur, Uu, Uu, Sm, Tb^Tf, Tb, Uh, Uu, Tb^Tf, Tb^Tf, Uu, Uh^Tf, Uh, Wwg^Es, Wwg^Es, Tb, Uu^Tf, Tb, Ur, Ur, Tb, Sm, Uh, Tb, Uh, Uu, Uh^Tf, Ur, Uu, Qxu, Uu
Xu, Xu, Xoa, Xoa, Ur, Uh, Uh^Tf, Ur, Uu, Sm, Uu, Uu, Tb, Uu, Uu^Tf, Tb, Tb, Tb, Sm, Tb^Tf, Uu, Sm, Sm, Uh, Uu^Tf, Uu, Tb, Tb, Uh^Tf, Ur, Uu, Ur, Uu^Tf, Uu, Qxu, Qxu
Xoa, Xoa, 1 Uu, Uu^Tf, Uh, Ur, Ur, Uu^Tf, Ur, Uh, Ur, Tb, Ur, Uu, Uu, Ur^Edb, Xu, Sm, Wog, Uu^Tf, Wog^Es, Wwg^Es, Xu, Uh, Ur, Uu^Edb, Ur^Edb, Uu, Ur, Ur, Xu, Uu^Tf, Qxu, Qxu, Qxu, Qxu
Ur, Ur, Ur, 2 Uh, Xoa, Xoa, Xu, Ur, Uu, Ur, Uu, Uu, Uh^Tf, Uh, Xu, Xu, Xu, Xu, Wog, Wog, Wog, Wog, Xu, Xu, Xu, Uu^Edb, Ur, Ur^Edb, Qxu, Xu, Xu, Xu, Xu, Qxu, Xu, Qxu
Uu, Uu, Xoa, Xoa, Xu, Xu, Xu, Xu, Xu, Xu, Xu, Uu^Tf, Xu, Xu, Xu, Xu, Xu, Xu, Xu, Wog, Wog, Xu, Xu, Xu, Xu, Xu, Xu, Qxu, Qxu, Qxu, Qxu, Xu, Xu, Xu, Xu, Xu
Xoa, Xoa, Xu, Xu, Xu, Xu, Xu, Xu, Xu, Xu, Xu, Xu, Xu, Xu, Xu, Xu, Xu, Xu, Xu, Wog, Xu, Xu, Xu, Xu, Xu, Xu, Xu, Qxu, Qxu, Qxu, Qxu, Xu, Xu, Xu, Xu, Xu
Xu, Xu, Xu, Xu, Xu, Xu, Xu, Xu, Xu, Xu, Xu, Xu, Xu, Xu, Xu, Xu, Xu, Xu, Xu, Xu, Xu, Xu, Xu, Xu, Xu, Xu, Xu, Xu, Xu, Xu, Xu, Xu, Xu, Xu, Xu, Xu
Xu, Xu, Xu, Xu, Xu, Xu, Xu, Xu, Xu, Xu, Xu, Xu, Xu, Xu, Xu, Xu, Xu, Xu, Xu, Xu, Xu, Xu, Xu, Xu, Xu, Xu, Xu, Xu, Xu, Xu, Xu, Xu, Xu, Xu, Xu, Xu
