Wog, Wog, Wog, Wog, Wog, Wog, Wog, Wog, Wog, Wog, Wog, Wog, Wog, Wog, Wog, Wog, Wog, Wog, Wog, Wog, Wog, Wog, Wog, Wog, Wog, Wog, Wog, Wog, Wog, Wog, Wog, Wog, Wog, Wog, Wog, Wog
Wog, Wog, Wog, Wog, Wog, Wog, Wwg, Wog, Wwrg, Wwg, Wwg, Wog, Wwg, Wog, Wog, Wog, Wog, Wog, Wog, Wog, Wog, Wog, Wog, Wog, Wog, Wog, Wog, Wog, Wog, Wog, Wog, Wog, Wwg, Wog, Wog, Wog
Wog, Wog, Wwrg, Wwrg, Wwrg, Wwg, Wwf, Wwrg, Tb, Tb^Tf, Tb^Tf, Wwg, Tb, Wwrg, Wwrg, Wwg, Wwg, Wog, Wwrg, Wwg, Wwg, Wog, Wwrg, Wog, Wog, Wog, Wwrg, Wog, Wwg, Wwg, Wwrg, Wwrg, Tb, Wwg, Wwg, Wog
Wog, Wwg, Uh, Tb^Tf, Tb^Tf, Uh, Uh, Wwf, Uh, Uh^Tf, Sm, Tb, Uh^Tf, Tb, Sm, Sm, Sm, Wwrg, Sm, Sm, Uh, Wwrg, Tb, Wwg, Wwg, Wwg, Wwf, Wwrg, Tb, Tb^Tf, Uh^Tf, Uh, Sm, Tb^Tf, Xu, Xu
Xu, Wwg, Sm, Uh^Tf, Tb, Sm, Sm, Sm, Sm, Sm, Tb, Uh, Uh^Tf, Tb^Tf, Wwg, Tb, Tb^Tf, Tb, Tb, Uh^Tf, Uh^Tf, Sm, Tb, Tb, Uh^Tf, Tb^Tf, Wwg, Wwf, Wwf, Tb^Tf, Sm, Uh, Tb, Sm, Xu, Xu
Xu, Xu, Sm, Tb^Tf, Tb, Sm, Sm, Sm, Tb, Sm, Sm, Sm, Tb, Wwg, Sm, Tb^Tf, Sm, Tb^Tf, Tb, Sm, Sm, Sm, Sm, Sm, Uh, Uh^Tf, Tb, Wwg, Wwf, Sm, Sm, Sm, Tb^Tf, Sm, Xu, Xu
Xu, Xu, Xu, Sm, Uh^Tf, Tb^Tf, Wwg, Tb, Tb, Tb, Sm, Tb, Wwg, Wwg, Sm, Sm, Sm, Sm, Tb, Sm, Sm, Tb^Tf, Tb^Tf, Uh^Tf, Sm, Sm, Sm, Wwg, Sm, Sm, Sm, Tb^Tf, Sm, Tb, Xu, Xu
Xu, Xu, Xu, Uh, Uh, Tb^Tf, Wwg, Tb, Uh, Sm, Sm, Sm, Tb^Tf, Tb, Sm, Sm, Sm, Tb, Tb^Tf, Sm, Tb, Sm, Sm, Tb, Tb^Tf, Sm, Tb, Tb, Uh, Uh, Sm, Sm, Sm, Xu, Xu, Xu
Xu, Xu, Sm, Sm, Tb, Wwg, Sm, Sm, Uh, Uh, Sm, Sm, Tb, Uh, Uh^Tf, Tb^Tf, Sm, Tb^Tf, Uh^Tf, Tb, Sm, Tb, Wwg, Tb, Sm, Sm, Sm, Sm, Sm, Uh^Tf, Tb^Tf, Sm, Wwg, Xu, Xu, Xu
Xu, Xu, Uh^Tf, Tb^Tf, Wwg, Wwg, Wwg, Sm, Wwg, Tb, Wwf, Sm, Sm, Uh, Wwg, Tb^Tf, Uh^Tf, Uh, Uh, Tb, Sm, Wwg, Sm, Wwg, Tb^Tf, Sm, Wwg, Sm, Tb, Tb^Tf, Sm, Wwrg, Wog, Xu, Wo, Wo
Xu, Xu, Xu, Wwg, Uh^Tf, Uh, Sm, Wwg, Tb, Wwf, Sm, Wwg, Wwg, Wwg, Wwg, Tb, Tb, Uh, Wwg, Tb^Tf, Tb, Tb, Uh, Sm, Tb, Wwg, Tb, Wwf, Wwf, Sm, Wwf, Wwrg, Xu, Wog, Xu, Xu
Xu, Xu, Xu, Wwg, Tb^Tf, Sm, Sm, Tb, Uh, Tb, Sm, Sm, Sm, Tb^Tf, Uh^Tf, Uh, Tb, Tb^Tf, Uh^Tf, Wwg, Tb, Uh, Uh^Tf, Tb, Wwg, Wwg, Tb^Tf, Tb^Tf, Uh^Tf, Wwf, Xu, Xu, Xu, Xu, Xu, Xu
Xu, Xu, Xu, Sm, Sm, Tb, Tb, Tb^Tf, Uh^Tf, Uh, Tb^Tf, Sm, Tb^Tf, Tb^Tf, Sm, Uh, Tb, Uh^Tf, Tb^Tf, Wwg, Sm, Uh^Tf, Tb^Tf, Sm, Wwf, Tb, Sm, Sm, Uh, Uh, Sm, Xu, Xu, Xu, Xu, Xu
Xu, Xu, Xu, Sm, Wwf, Tb, Sm, Uh^Tf, Uh, Tb, Tb, Wwg, Wwg, Sm, Sm, Wwf, Wwf, Sm, Tb, Tb, Wwg, Sm, Tb^Tf, Tb, Wwf, Wwf, Uh^Tf, Sm, Tb^Tf, Sm, Sm, Xu, Xu, Xu, Qxu, Qxu
Xu, Xu, Wog, Wwrg, Wwg, Wwf, Wwg, Sm, Tb, Tb, Uh, Sm, Wwg, Sm, Sm, Sm, Tb, Sm, Wwf, Wwf, Sm, Wwg, Wwg, Wwf, Sm, Uh, Uh^Tf, Tb, Tb^Tf, Tb^Tf, Sm, Xu, Xu, Qxu, Ur, Qxu
Wog, Wog, Xu, Wog, Uu^Tf, Uh, Ur, Wwg, Sm, Tb^Tf, Uh^Tf, Uh, Wwg, Tb, Uh^Tf, Uh, Sm, Tb, Tb, Sm, Ur, Uh, Uu, Sm, Tb, Tb^Tf, Sm, Sm, Sm, Tb, Uu^Tf, Xu, Uh, Uu^Tf, Uu, Ur
Xu, Xu, Xu, Xu, Uu, Ur, Uu, Uu, Sm, Tb^Tf, Tb, Uh, Wwg, Tb^Tf, Tb^Tf, Sm, Uh^Tf, Uh, Uu, Ur, Ur, Uu^Tf, Ur, Ur, Ur, Tb, Sm, Uh, Tb, Uh, Uu, Uh^Tf, Ur, Uu, Qxu, Uu
Xu, Xu, Xoa, Xoa, Ur, Uh, Uh^Tf, Ur, Uu, Sm, Wwf, Wwf, Tb, Sm, Uu^Tf, Ur, Uu, Ur, Uh, Uh^Tf, Qxu, Qxu, Qxu, Uh, Uu^Tf, Sm, Tb, Tb, Uh^Tf, Ur, Uu, Ur, Uu^Tf, Uu, Qxu, Qxu
Xoa, Xoa, 1 Uu, Uu^Tf, Uh, Ur, Ur, Uu^Tf, Ur, Uh, Ur, Tb, Ur, Uu, Uu, Ur, Qxu, Qxu, Qxu, Qxu, Qxu, Qxu, Qxu, Uh, Ur, Uu, Ur, Uu, Ur, Ur, Xu, Uu^Tf, Qxu, Qxu, Qxu, Qxu
Ur, Ur, Ur, 2 Uh, Xoa, Xoa, Xu, Ur, Uu, Ur, Uu, Uu, Uh^Tf, Uh, Xu, Qxu, Qxu, Qxu, Qxu, Qxu, Qxu, Qxu, Xu, Xu, Xu, Uu, Ur, Ur, Qxu, Xu, Xu, Xu, Xu, Qxu, Xu, Qxu
Uu, Uu, Xoa, Xoa, Xu, Xu, Xu, Xu, Xu, Xu, Xu, Uu^Tf, Xu, Xu, Xu, Qxu, Qxu, Qxu, Qxu, Qxu, Qxu, Qxu, Xu, Xu, Xu, Xu, Xu, Qxu, Qxu, Qxu, Qxu, Xu, Xu, Xu, Xu, Xu
Xoa, Xoa, Xu, Xu, Xu, Xu, Xu, Xu, Xu, Xu, Xu, Xu, Xu, Xu, Xu, Xu, Xu, Xu, Xu, Qxu, Xu, Xu, Xu, Xu, Xu, Xu, Xu, Qxu, Qxu, Qxu, Qxu, Xu, Xu, Xu, Xu, Xu
Xu, Xu, Xu, Xu, Xu, Xu, Xu, Xu, Xu, Xu, Xu, Xu, Xu, Xu, Xu, Xu, Xu, Xu, Xu, Xu, Xu, Xu, Xu, Xu, Xu, Xu, Xu, Xu, Xu, Xu, Xu, Xu, Xu, Xu, Xu, Xu
Xu, Xu, Xu, Xu, Xu, Xu, Xu, Xu, Xu, Xu, Xu, Xu, Xu, Xu, Xu, Xu, Xu, Xu, Xu, Xu, Xu, Xu, Xu, Xu, Xu, Xu, Xu, Xu, Xu, Xu, Xu, Xu, Xu, Xu, Xu, Xu
