Uu, Rb, Rb, Xu, Xu, Xu, Xu, Xu, Qxu, Qxu, Qxu, Rb, Rb, Xu, Xu, Xu, Xu, Xu, Xu, Xu, Xu, Xu, Xu
Xu, Uu, Rb, Uh, Uh, Xu, Qxu, Xu, Xu, Qxu, Qxu, Rb, Uh, Xu, Qxu, Xu, Qxu, Xu, Xu, Xu, Xu, Xu, Xu
Xu, Xu, Xu, Uu, Uu, Qxu, Qxu, Qxu, Xu, Qxu, Qxu, Rb, Rb, Qxu, Qxu, Qxu, Qxu, Qxu, Xu, Xu, Xu, Xu, Xu
Xu, Xu, Xu, Rb, Rb, Uh, Uh, Qxu, Xu, Qxu, Uh, Uh, Uu, Qxu, Xu, Qxu, Qxu, Qxu, Uh, Uh, Rb, Xu, Xu
Uu, Xu, Uh, Uh, Uu, Rb, Rb, Rb, Rb, Xu, Uu, Uu, Xu, Xu, Xu, Xu, Uu, Rb, Rb, Rb, Uu, Uh, Uh
Rb, Rb, Rb, Rb, Qxu, Xu, Xu, Uh, Uh, Uu, Rb, Uh, Xu, Xu, Xu, Uh, Uh, Uu, Qxu, Qxu, Qxu, Uh, Uu
Xu, Uu, Xu, Qxu, Xu, Xu, Xu, Qxu, Qxu, Uu, Rb, Uh, Xu, Xu, Xu, Uh, Rb, Xu, Xu, Qxu, Qxu, Xu, Xu
Xu, Xu, Xu, Xu, Xu, Xu, Uh, Xu, Xu, Xu, Uu, Rb, Uh, Xu, Xu, Rb, Rb, Xu, Uu, Rb, Uh, Xu, Xu
Xu, Xu, Xu, Xu, Rb, Uh, Rb, Rb, Rb, Uh, Uu, Rb, Uh, Xu, Uh, Uh, Uu, Uu, Uh, Rb, Rb, Uh, Uu
Uu, Rb, Rb, 1 Uu, 2 Uu, Rb, Xu, Uh, Uh, Uu, Uu, Uu, Rb, Rb, Rb, Uu, Xu, Uh, Qxu, Qxu, Qxu, Uu, Uu
Uu, Uh, Uh, Uu, Qxu, Xu, Xu, Xu, Uu, Rb, Rb, Uu, Uu, Uu, Uu, Xu, Xu, Xu, Xu, Qxu, Qxu, Qxu, Qxu
Xu, Xu, Xu, Qxu, Xu, Xu, Xu, Uu, Uh, Rb, Xu, Uh, Xu, Uu, Rb, Uh, Uh, Xu, Xu, Xu, Xu, Xu, Xu
Xu, Xu, Xu, Xu, Qxu, Qxu, Qxu, Rb, Uh, Xu, Qxu, Xu, Xu, Xu, Xu, Rb, Rb, Xu, Qxu, Xu, Xu, Xu, Xu
Xu, Xu, Xu, Xu, Qxu, Qxu, Rb, Rb, Uu, Qxu, Xu, Qxu, Qxu, Xu, Qxu, Uh, Rb, Qxu, Qxu, Qxu, Xu, Xu, Xu
Xu, Xu, Xu, Xu, Uh, Uh, Uu, Uu, Xu, Xu, Xu, Xu, Qxu, Qxu, Qxu, Uh, Uu, Uh, Uh, Qxu, Xu, Xu, Xu
Xu, Xu, Xu, Rb, Rb, Uu, Xu, Xu, Xu, Xu, Xu, Xu, Xu, Xu, Xu, Qxu, Xu, Uu, Rb, Xu, Xu, Xu, Xu
Xu, Xu, Xu, Rb, Uu, Xu, Xu, Xu, Xu, Xu, Xu, Xu, Xu, Xu, Xu, Xu, Xu, Rb, Rb, Xu, Xu, Xu, Xu
