Uu, Rb, Rb^Qhu, Xu, Xu, Xu, Xu, Xu, Qxu, Qxu, Qxu, Rb, Rb, Xu, Xu, Xu, Xu, Xu, Xu, Xu, Xu, Xu, Xu
Xu, Uu^Edt, Rb^Edt, Uh, Uh^Tf, Xu, Qxu, Xu, Xu, Qxu, Qxu, Rb^Qhu, Uh^Tf, Xu, Qxu, Xu, Qxu, Xu, Xu, Xu, Xu, Xu, Xu
Xu, Xu, Xu, Uu^Tf, Uu^Edt, Qxu, Qxu, Qxu, Xu, Qxu, Qxu, Rb^Qhu, Rb^Edt, Qxu, Qxu, Qxu, Qxu, Qxu, Xu, Xu, Xu, Xu, Xu
Xu, Xu, Xu, Rb^Edt, Rb^Edt, Uh^Edt, Uh^Edt, Qxu, Xu, Qxu, Uh^Tf, Uh, Uu, Qxu, Xu, Qxu, Qxu, Qxu, Uh, Uh^Tf, Rb^Edt, Xu, Xu
Uu, Xu, Uh^Edt, Uh^Tf, Uu^Tf, Rb^Qhu, Rb^Qhu, Rb^Edt, Rb^Qhu, Xu, Uu^Edt, Uu^Tf, Xu, Xu, Xu, Xu, Uu, Rb^Edt, Rb^Qhu, Rb^Qhu, Uu^Tf, Uh^Tf, Uh
Rb, Rb^Edt, Rb^Qhu, Rb^Qhu, Qxu, Xu, Xu, Uh, Uh^Tf, Uu^Edt, Rb^Edt, Uh, Xu, Xu, Xu, Uh, Uh^Tf, Uu^Tf, Qxu, Qxu, Qxu, Uh, Uu
Xu, Uu, Xu, Qxu, Xu, Xu, Xu, Qxu, Qxu, Uu, Rb, Uh, Xu, Xu, Xu, Uh, Rb^Qhu, Xu, Xu, Qxu, Qxu, Xu, Xu
Xu, Xu, Xu, Xu, Xu, Xu, Uh, Xu, Xu, Xu, Uu, Rb, Uh^Tf, Xu, Xu, Rb^Qhu, Rb^Qhu, Xu, Uu^Qhh, Rb, Uh, Xu, Xu
Xu, Xu, Xu, Xu, Rb^Edt, Uh^Tf, Rb^Edt, Rb^Edt, Rb, Uh, Uu, Rb, Uh, Xu, Uh^Tf, Uh, Uu, Uu^Qhh, Uh^Tf, Rb^Edt, Rb^Edt, Uh^Tf, Uu
Uu, Rb^Qhu, Rb^Qhu, 1 Uu^Edt, 2 Uu^Edt, Rb^Edt, Xu, Uh, Uh^Tf, Uu^Tf, Uu, Uu, Rb, Rb, Rb, Uu, Xu, Uh^Tf, Qxu, Qxu, Qxu, Uu, Uu
Uu, Uh, Uh^Tf, Uu^Edt, Qxu, Xu, Xu, Xu, Uu, Rb, Rb, Uu^Tf, Uu, Uu^Edt, Uu^Tf, Xu, Xu, Xu, Xu, Qxu, Qxu, Qxu, Qxu
Xu, Xu, Xu, Qxu, Xu, Xu, Xu, Uu, Uh, Rb, Xu, Uh, Xu, Uu^Edt, Rb^Qhu, Uh, Uh^Tf, Xu, Xu, Xu, Xu, Xu, Xu
Xu, Xu, Xu, Xu, Qxu, Qxu, Qxu, Rb^Qhu, Uh, Xu, Qxu, Xu, Xu, Xu, Xu, Rb^Qhu, Rb^Edt, Xu, Qxu, Xu, Xu, Xu, Xu
Xu, Xu, Xu, Xu, Qxu, Qxu, Rb^Qhu, Rb^Edt, Uu^Edt, Qxu, Xu, Qxu, Qxu, Xu, Qxu, Uh^Tf, Rb^Edt, Qxu, Qxu, Qxu, Xu, Xu, Xu
Xu, Xu, Xu, Xu, Uh, Uh^Tf, Uu^Tf, Uu^Edt, Xu, Xu, Xu, Xu, Qxu, Qxu, Qxu, Uh^Tf, Uu^Tf, Uh^Tf, Uh, Qxu, Xu, Xu, Xu
Xu, Xu, Xu, Rb, Rb^Qhh, Uu^Qhh, Xu, Xu, Xu, Xu, Xu, Xu, Xu, Xu, Xu, Qxu, Xu, Uu^Tf, Rb^Edt, Xu, Xu, Xu, Xu
Xu, Xu, Xu, Rb^Qhh, Uu^Qhh, Xu, Xu, Xu, Xu, Xu, Xu, Xu, Xu, Xu, Xu, Xu, Xu, Rb^Edt, Rb, Xu, Xu, Xu, Xu
