Xu, Xuc, Rb, Uu, Xuc, Xu, Xu, Xu, Xu, Uu, Uu, Xu, Xu, Xuc, Rb, Uu, Xuc, Xu, Xu, Xu, Xu, Xu, Xu, Xu, Xu, Xu, Xu, Xu, Xu, Xu, Xu, Xu, Xu
Xu, Xuc, Uu, Rb, Xuc, Xu, Xu, Xu, Uu, Uu, Uu, Xu, Xuc, Xuc, Rb, Uu, Xuc, Xu, Xu, Xu, Xu, Xu, Xu, Xu, Xu, Xu, Xu, Xu, Xu, Xu, Xu, Xu, Xu
Xu, Xuc, Uu, Rb, Xuc, Uu, Xu, Uu, Uu, Uu, Uu, Uu, Xur, Rb, Uu, Uu, Xuc, Xu, Xu, Uu, Uu, Uu, Uu, Xu, Xu, Xu, Uu, Xu, Xu, Xu, Xuc, Xu, Xuc
Xu, Xuc, Rb, Uu, Xuc, Uu, Xu, Uu, Uu, Uu, Uu, Uu, Xur, Uu, Isa, Xuc, Uu, Uu, Uu, Uu, Uu, Uu, Uu, Xu, Xuc, Uu, Xuc, Xuc, Xuc, Xuc, Rb, Xuc, Isa
Xu, Xuc, Rb, Rb, Uu, Xuc, Xuc, Xu, Xu, Uu, Uu, Xu, Xuc, Isa, Rb, Xuc, Uu, Uu, Uu, Uu, Uu, Xu, Xuc, Xuc, Uu, Xuc, Isa, Isa, Isa, Rb, Isa, Isa, Uu
Xu, Xuc, Xuc, Isa, Isa, Uu, Isa, Xuc, Xur, Uu, Xu, Xuc, Uu, Isa, Rb, Xuc, Xu, Uu, Xu, Uu, Xuc, Xuc, Rb, Rb, Isa, Isa, Uu, Uu, Rb, Isa, Uu, Uu, Xuc
Xu, Xu, Xuc, Uu, Uu, Isa, Rb, Isa, Isa, Xur, Xuc, Xuc, Uu, Isa, Uu, Xuc, Xuc, Uu, Uu, Xuc, Uu, Uu, Isa, Isa, Xuc, Uu, Xuc, Xuc, Xuc, Rb, Xuc, Xuc, Xu
Xu, Xu, Xu, Xuc, Xur, Xur, Xuc, Rb, Isa, Uu, Xuc, Xuc, Rb, Isa, Isa, Uu, Xuc, Xu, Xuc, Xuc, Rb, Isa, Xuc, Xuc, Xu, Xuc, Uu, Uu, Xu, Xuc, Uu, Xu, Xu
Xu, Sm^Tf, Sm^Tf, Xu, Rb, Rb, Xu, Xuc, Isa, Uu, Xuc, Xuc, Xuc, Rb, Uu, Isa, Rb, Xuc, Uu, Xuc, Rb, Isa, Uu, Xuc, Xu, Uu, Uu, Uu, Uu, Xu, Uu, Uu, Xu
Xu, Xu, Uu, Xu, Xuf, Xuf, Sm^Ii, Uu, Isa, Rb, Rb, Xuc, Uu, Xur, Xur, Isa, Isa, Xuc, Rb, Xuc, Xuc, Isa, Uu, Xuc, Xuc, Xu, Uu, Uu, Uu, Uu, Uu, Uu, Xu
Xu, Xu, Xuf, Uh, Sm^Dr, Uu^Tf, Rb^Tf, Sm^Dr, Xuc, Isa, Uu, Xur, Uu, Uu, Xuc, Rb, Isa, Rb, Ce, Rb, Ce, Isa, Isa, Uu, Xuc, Xu, Xu, Uu, Uu, Uu, Uu, Xu, Xu
Xu, Xuf, Gll^Tfi, Sm, Sm^Ii, Rb^Ii, Xu, Xu, Xuc, Isa, Uu, Xur, Xuc, Xuc, Uu, Rb, Isa, Uu, Ce, Ket, Ce, Rb, Isa, Rb, Rb, Xuc, Xuc, Xu, Uu, Uu, Uu, Xu, Xu
Xu, Xuf, Uu^Tf, Uu^Tf, Xuf, Xu, Xuc, Xuc, Isa, Isa, Isa, Rb, Rb, Uu, Isa, Isa, Rb, Isa, Isa, Rb, Isa, Isa, Uu, Isa, Isa, Isa, Isa, Xuc, Xuc, Uu, Xu, Xu, Xu
Xu, Xu, Sm^Dr, Uu^Ii, Xuf, Xuc, Uu, Isa, Rb, Rb, Uu, Isa, Isa, Isa, Uu, Uu, Xur, Rb, Uu, Isa, Rb, Rb, Xuc, Uu, Uu, Uu, Rb, Isa, Isa, Xuc, Xu, Xu, Xu
Xu, Xu, Sm, Uh, Xu, Xuc, Uu, Isa, Uu, Xuc, Xuc, Uu, Xuc, Xuc, Xuc, Xuc, Uu, Xur, Xuc, Uu, Xuc, Xuc, Xu, Xuc, Xuc, Xuc, Xuc, Rb, Isa, Xuc, Xuc, Xu, Xu
Xu, Xuf, Uu^Tf, Sm^Tf, Xu, Xuc, Rb, Isa, Uu, Xuc, Xuc, Xuc, Uu, Uu, Xu, Xu, Xu, Uu, Xu, Xuc, Uu, Uu, Uu, Uu, Uu, Xu, Xuc, Rb, Isa, Uu, Xuc, Xu, Xu
Xu, Xuf, Uu, Gll^Tfi, Xu, Xuc, Rb, Isa, Isa, Uu, Xuc, Xu, Xu, Uu, Uu, Uu, Uu, Xu, Xu, Uu, Uu, Uu, Uu, Uu, Uu, Uu, Xu, Xuc, Isa, Uu, Uu, Xuc, Xu
Xu, Xu, Sm, Gll^Ii, Xuf, Xuc, Xuc, Uu, Isa, Rb, Rb, Xuc, Xu, Uu, Uu, Uu, Uu, Xu, Xu, Uu, Uu, Uu, Uu, Uu, Uu, Uu, Xu, Xuc, Isa, Isa, Uu, Xuc, Xu
Xu, Xu, Sm, Sm^Tf, Uh^Tf, Xuf, Xuc, Uu, Isa, Uu, Rb, Xuc, Xuc, Uu, Xu, Uu, Xu, Xu, Uu, Uu, Uu, Uu, Uu, Uu, Uu, Uu, Uu, Xuc, Xuc, Isa, Rb, Xuc, Xu
Xu, Xu, Xu, Uu^Ii, Gll^Ii, Xu, Xuc, Rb, Isa, Cud, Uu, Uu, Uu, Xuc, Xuc, Xuc, Xuc, Xu, Uu, Uu, Uu, Uu, Xu, Uu, Xu, Uu, Xu, Xu, Xuc, Isa, Rb, Xuc, Xu
Xu, Xu, Xuf, Rb, Uu, Xu, Xu, Xuc, Xuc, Uu, Uu, Cud, Kud, Rb, Rb, Uu, Uu, Xuc, Xu, Uu, Xuc, Xu, Xuc, Xuc, Xuc, Xuc, Xuc, Uu, Xuc, Isa, Uu, Xuc, Xu
Xu, Xuf, Uu^Tf, Sm, Sm, Sm, Uu, Xu, Xuc, Rb, Rb, Cud, Cud, Cud, Uu, Cud, Uu, Xuc, Xuc, Xuc, Uu, Xuc, Isa, Isa, Isa, Rb, Isa, Xuc, Isa, Isa, Uu, Xuc, Xu
Xu, Xuf, Gll^Ii, Rb^Tf, Xu, Xu, Sm, Xu, Xuc, Isa, Isa, Uu, Isa, Uu, Isa, Uu, Rb, Rb, Uu, Uu, Isa, Isa, Uu, Rb, Rb, Isa, Uu, Isa, Isa, Rb, Xuc, Xuc, Xu
Xu, Xu, Sm^Ii, Uu, Xu, Xu, Sm^Dr, Xu, Xu, Uu, Isa, Isa, Uu, Isa, Uu, Isa, Isa, Isa, Isa, Isa, Uu, Uu, Xuc, Xuc, Xuc, Xuc, Xuc, Uu, Isa, Rb, Xuc, Xu, Xu
Xu, Xu, Sm, Sm, Xuf, Xu, Uu^Dr, Xur, Xur, Isa, Rb, Rb, Cud, Uu, Cud, Xuc, Xuc, Uu, Isa, Uu, Uu, Xuc, Uu, Uu, Xuc, Xuc, Isa, Isa, Uu, Uu, Xuc, Xu, Xu
Xu, Xu, Uu^Tf, Uh^Tf, Gll^Ii, Xuf, Xur, Xur, Rb, Isa, Uu, Xuc, Xuc, Cud, Xuc, Xuc, Uu, Uu, Isa, Isa, Rb, Xuc, Uu, Uu, Xuc, Isa, Uu, Uu, Xuc, Xuc, Xu, Xu, Xu
Xu, Xu, Xu, Rb^Ii, Sm, Xuf, Xu, Xur, Xuc, Isa, Uu, Xuc, Uu, Xuc, Uu, Xur, Isa, Isa, Uu, Rb, Xuc, Xuc, Uu, Xuc, Uu, Isa, Rb, Xuc, Xu, Uu, Uu, Xu, Xu
Xu, Xu, Xuf, Sm, Uu^Tf, Sm, Uu^Tf, Xu, Xuc, Isa, Rb, Xur, Uu, Uu, Xuc, Xur, Isa, Uu, Xuc, Xuc, Uu, Xu, Xuc, Xuc, Uu, Isa, Rb, Xuc, Xu, Uu, Uu, Xu, Xu
Xu, Xu, Xuf, Rb^Tf, Gll^Ii, Xu, Sm^Tf, Xu, Xuc, Isa, Rb, Xur, Uu, Uu, Xuc, Uu, Isa, Rb, Xuc, Uu, Uu, Xu, Xuc, Rb, Isa, Isa, Xuc, Xuc, Uu, Uu, Xu, Xu, Xu
Xu, Xu, Xu, Uu^Ii, Uh, Xu, Sm, Xu, Xuc, Isa, Isa, Xuc, Xuc, Uu, Xur, Uu, Isa, Rb, Xuc, Uu, Uu, Uu, Xuc, Rb, Isa, Uu, Xuc, Xu, Uu, Uu, Xu, Xu, Xu
Xu, Xu, Rb, Sm, Sm, Xu, Uu^Tf, Xu, Xuc, Rb, Uu, Isa, Xuc, Xu, Uu, Xur, Isa, Uu, Xuc, Xu, Uu, Uu, Xuc, Uu, Isa, Xuc, Xu, Xu, Uu, Uu, Xu, Xu, Xu
Xu, Xuf, Uh, Uu, Xuf, Xu, Xuf, Xu, Xuc, Rb, Rb, Uu, Isa, Xuc, Xu, Xur, Isa, Uu, Rb, Xuc, Xu, Xu, Xuc, Uu, Isa, Xuc, Xuc, Uu, Xu, Uu, Uu, Xu, Xu
Xu, Xuf, Xuf, Gg, Xuf, Xuf, Gg^Fp, Xuf, Xuf, Xuc, Xuc, Uu, Isa, Xuc, Uu, Xuc, Isa, Uu, Rb, Xuc, Xu, Xu, Xuc, Uu, Rb, Isa, Isa, Xuc, Xuc, Uu, Xu, Xu, Xu
Xu, Xuf, Gs^Fp, Gg^Fds, Gs^Fp, Gg, Gg^Fet, Gs^Fp, Xuf, Xu, Xuc, Uu, Isa, Xur, Uu, Xuc, Isa, Uu, Xuc, Xuc, Uu, Uu, Uu, Xuc, Xuc, Rb, Isa, Uu, Xuc, Xu, Uu, Xu, Xu
Xu, Xuf, Gg^Fp, Wwf^Ii, Wwf^Ii, Gs^Fp, Gs^Fds, Gg^Fds, Xu, Xu, Xuc, Rb, Isa, Xur, Xuc, Xuc, Isa, Rb, Xuc, Uu, Uu, Uu, Uu, Uu, Xuc, Rb, Uu, Isa, Xuc, Uu, Uu, Xu, Xu
Xu, Xuf, Gg^Fds, Gg^Fet, Gs^Fp, Wwf, Xuf, Xu, Xuc, Xuc, Rb, Rb, Isa, Uu, Xuc, Xuc, Isa, Rb, Xuc, Uu, Uu, Uu, Uu, Uu, Xu, Xuc, Uu, Isa, Uu, Xuc, Uu, Xu, Xu
Xu, Xuf, Xuf, Gs, Wwf^Ii, Gg^Fp, Xuf, Xuc, Rb, Uu, Isa, Isa, Uu, Uu, Xuc, Xuc, Uu, Isa, Xuc, Uu, Uu, Uu, Uu, Uu, Xuc, Xuc, Uu, Isa, Rb, Xuc, Uu, Xu, Xu
Xu, Xu, Xuf, Wwf^Ii, Gs^Fds, Gg^Fds, Xuf, Xuc, Rb, Isa, Uu, Uu, Xuc, Xuc, Xuc, Xuc, Rb, Isa, Uu, Xuc, Uu, Uu, Uu, Uu, Xuc, Rb, Isa, Isa, Rb, Xuc, Xuc, Uu, Xuc
Xuf, Xuf, Xuf, Wwf, Gs^Fp, Gg^Fet, Xuf, Xuc, Xuc, Isa, Rb, Xur, Uu, Uu, Xuc, Uu, Rb, Isa, Uu, Xuc, Xuc, Uu, Uu, Uu, Xuc, Rb, Isa, Uu, Ce, Rb, Uu, Xuc, Rb
Qxu, Qxu, Qxu, Gg^Fp, Wwf^Ii, Gs, Gg^Fp, Xuf, Xuc, Isa, Rb, Xur, Xur, Xuc, Rb, Uu, Isa, Isa, Isa, Uu, Rb, Xuc, Xuc, Xuc, Ce, Uu, Isa, Ce, Ket, Ce, Uu, Rb, Isa
Qxu, Qxu, Gg^Fet, Gg^Ii, Wwf, Gg^Fds, Ds^Esd, Xuf, Xuc, Isa, Isa, Uu, Uu, Rb, Isa, Isa, Rb, Rb, Xuc, Isa, Isa, Rb, Uu, Uu, Ce, Uu, Isa, Uu, Uu, Ce, Isa, Isa, Xuc
Qxu, Qxu, Gs^Fp, Gs^Fds, Gs^Fp, Ds, Wwrg, Xuf, Xuf, Xuc, Xuc, Isa, Isa, Isa, Xuc, Uu, Xuc, Xuc, Uu, Xuc, Xuc, Isa, Isa, Uu, Isa, Isa, Rb, Isa, Isa, Isa, Xuc, Xuc, Xu
Qxu, Qxu, Gg^Fp, Wwf^Ii, Ds^Esd, Ds^Esd, Wwg^Ii, Wog, Qxu, Xu, Xu, Xuc, Xuc, Xuc, Uu, Xuc, Uu, Xu, Uu, Uu, Xuc, Uu, Rb, Isa, Uu, Uu, Ce, Rb, Uu, Uu, Xuc, Xu, Xu
Qxu, Qxu, Qxu, Wwf^Esd, Wwrg, Wwg, Wog^Ii, Wog^Ii, Qxu, Qxu, Qxu, Xu, Xu, Xu, Uu, Uu, Uu, Uu, Xu, Uu, Xu, Xuc, Xuc, Rb, Xuc, Xuc, Xuc, Xuc, Xuc, Xuc, Xu, Xu, Xu
Qxu, Qxu, Qxu, Qxu, Qxu, Wog, Qxu, Qxu, Qxu, Qxu, Qxu, Qxu, Qxu, Xu, Xu, Xu, Xu, Uu, Xu, Xu, Xu, Xu, Xu, Xuc, Xu, Xu, Xu, Xu, Xu, Xu, Xu, Xu, Xu
Qxu, Qxu, Qxu, Qxu, Qxu, Qxu, Qxu, Qxu, Xu, Xu, Xu, Qxu, Qxu, Xu, Xu, Xu, Xu, Xu, Xu, Xu, Xu, Xu, Xu, Xu, Xu, Xu, Xu, Xu, Xu, Xu, Xu, Xu, Xu
