Xu, Xu, Uu, Uu, Xu, Xu, Xu, Xu, Xu, Uu, Uu, Xu, Xu, Xu, Uu, Uu, Xu, Xu, Xu, Xu, Xu, Xu, Xu, Xu, Xu, Xu, Xu, Xu, Xu, Xu, Xu, Xu, Xu
Xu, Xu, Uu, Uu, Xu, Xu, Xu, Xu, Uu, Uu, Uu, Xu, Xu, Xu, Uu, Uu, Xu, Xu, Xu, Xu, Xu, Xu, Xu, Xu, Xu, Xu, Xu, Xu, Xu, Xu, Xu, Xu, Xu
Xu, Xu, Uu, Uu, Xu, Xu, Xu, Uu, Uu, Uu, Uu, Uu, Xu, Uu, Uu, Uu, Xu, Xu, Xu, Uu, Uu, Uu, Uu, Xu, Xu, Xu, Xu, Xu, Xu, Xu, Xu, Xu, Xu
Xu, Xu, Uu, Uu, Xu, Xu, Xu, Uu, Uu, Uu, Uu, Uu, Xu, Uu, Isa, Xu, Uu, Uu, Uu, Uu, Uu, Uu, Uu, Xu, Xu, Xu, Xu, Xu, Xu, Xu, Uu, Xu, Isa
Xu, Xu, Uu, Uu, Uu, Xu, Xu, Xu, Xu, Uu, Uu, Xu, Xu, Isa, Uu, Xu, Uu, Uu, Uu, Uu, Uu, Xu, Xu, Xu, Uu, Xu, Isa, Isa, Isa, Uu, Isa, Isa, Uu
Xu, Xu, Xu, Isa, Isa, Uu, Isa, Xu, Xu, Uu, Xu, Xu, Uu, Isa, Uu, Xu, Xu, Uu, Xu, Uu, Xu, Xu, Uu, Uu, Isa, Isa, Uu, Uu, Uu, Isa, Uu, Uu, Xu
Xu, Xu, Xu, Uu, Uu, Isa, Uu, Isa, Isa, Xu, Xu, Xu, Uu, Isa, Uu, Xu, Xu, Uu, Uu, Xu, Uu, Uu, Isa, Isa, Xu, Uu, Xu, Xu, Xu, Uu, Xu, Xu, Xu
Xu, Xu, Xu, Xu, Xu, Xu, Xu, Uu, Isa, Uu, Xu, Xu, Uu, Isa, Isa, Uu, Xu, Xu, Xu, Xu, Uu, Isa, Xu, Xu, Xu, Xu, Uu, Uu, Xu, Xu, Uu, Xu, Xu
Xu, Sm^Tf, Sm^Tf, Xu, Xu, Xu, Xu, Xu, Isa, Uu, Xu, Xu, Xu, Uu, Uu, Isa, Uu, Xu, Uu, Xu, Uu, Isa, Uu, Xu, Xu, Uu, Uu, Uu, Uu, Xu, Uu, Uu, Xu
Xu, Xu, Uu, Xu, Xuf, Xuf, Sm, Uu, Isa, Uu, Uu, Xu, Xu, Xu, Xu, Isa, Isa, Xu, Uu, Xu, Xu, Isa, Uu, Xu, Xu, Xu, Uu, Uu, Uu, Uu, Uu, Uu, Xu
Xu, Xu, Xuf, Uh, Sm^Dr, Uu^Tf, Rb^Tf, Sm^Dr, Xu, Isa, Uu, Xu, Xu, Xu, Xu, Uu, Isa, Uu, Ce, Uu, Ce, Isa, Isa, Uu, Xu, Xu, Xu, Uu, Uu, Uu, Uu, Xu, Xu
Xu, Xuf, Gll^Tf, Sm, Sm, Rb, Xu, Xu, Xu, Isa, Uu, Xu, Xu, Xu, Uu, Uu, Isa, Uu, Ce, Ket, Ce, Uu, Isa, Uu, Uu, Xu, Xu, Xu, Uu, Uu, Uu, Xu, Xu
Xu, Xuf, Uu^Tf, Uu^Tf, Xuf, Xu, Xu, Xu, Isa, Isa, Isa, Uu, Uu, Uu, Isa, Isa, Uu, Isa, Isa, Uu, Isa, Isa, Uu, Isa, Isa, Isa, Isa, Xu, Xu, Uu, Xu, Xu, Xu
Xu, Xu, Sm^Dr, Uu, Xuf, Xu, Uu, Isa, Uu, Uu, Uu, Isa, Isa, Isa, Uu, Uu, Xu, Uu, Uu, Isa, Uu, Uu, Xu, Uu, Uu, Uu, Uu, Isa, Isa, Xu, Xu, Xu, Xu
Xu, Xu, Sm, Uh, Xu, Xu, Uu, Isa, Uu, Xu, Xu, Uu, Xu, Xu, Xu, Xu, Xu, Xu, Xu, Uu, Xu, Xu, Xu, Xu, Xu, Xu, Xu, Uu, Isa, Xu, Xu, Xu, Xu
Xu, Xuf, Uu^Tf, Sm^Tf, Xu, Xu, Uu, Isa, Uu, Xu, Xu, Xu, Uu, Uu, Xu, Xu, Xu, Xu, Xu, Xu, Uu, Uu, Uu, Uu, Uu, Xu, Xu, Uu, Isa, Uu, Xu, Xu, Xu
Xu, Xuf, Uu, Gll^Tf, Xu, Xu, Uu, Isa, Isa, Uu, Xu, Xu, Xu, Uu, Uu, Uu, Uu, Xu, Xu, Uu, Uu, Uu, Uu, Uu, Uu, Uu, Xu, Xu, Isa, Uu, Uu, Xu, Xu
Xu, Xu, Sm, Gll, Xuf, Xu, Xu, Uu, Isa, Uu, Uu, Xu, Xu, Uu, Uu, Uu, Uu, Xu, Xu, Uu, Uu, Uu, Uu, Uu, Uu, Uu, Xu, Xu, Isa, Isa, Uu, Xu, Xu
Xu, Xu, Sm, Sm^Tf, Uh^Tf, Xuf, Xu, Uu, Isa, Uu, Uu, Xu, Xu, Uu, Xu, Uu, Xu, Xu, Uu, Uu, Uu, Uu, Uu, Uu, Uu, Uu, Uu, Xu, Xu, Isa, Uu, Xu, Xu
Xu, Xu, Xu, Uu, Gll, Xu, Xu, Uu, Isa, Cud, Uu, Uu, Uu, Xu, Xu, Xu, Xu, Xu, Uu, Uu, Uu, Uu, Xu, Uu, Xu, Uu, Xu, Xu, Xu, Isa, Uu, Xu, Xu
Xu, Xu, Xuf, Rb, Uu, Xu, Xu, Uu, Isa, Uu, Uu, Cud, Kud, Uu, Uu, Uu, Uu, Xu, Xu, Uu, Xu, Xu, Xu, Xu, Xu, Xu, Xu, Xu, Xu, Isa, Uu, Xu, Xu
Xu, Xuf, Uu^Tf, Sm, Sm, Sm, Uu, Xu, Isa, Uu, Uu, Cud, Cud, Cud, Uu, Cud, Uu, Xu, Xu, Xu, Uu, Xu, Isa, Isa, Isa, Uu, Isa, Xu, Isa, Isa, Uu, Xu, Xu
Xu, Xuf, Gll, Rb^Tf, Xu, Xu, Sm, Xu, Uu, Isa, Isa, Uu, Isa, Uu, Isa, Uu, Uu, Uu, Uu, Uu, Isa, Isa, Uu, Uu, Uu, Isa, Uu, Isa, Isa, Uu, Xu, Xu, Xu
Xu, Xu, Sm, Uu, Xu, Xu, Sm^Dr, Xu, Cud, Uu, Isa, Isa, Uu, Isa, Uu, Isa, Isa, Isa, Isa, Isa, Uu, Uu, Xu, Xu, Xu, Xu, Xu, Uu, Isa, Uu, Xu, Xu, Xu
Xu, Xu, Sm, Sm, Xuf, Xu, Uu^Dr, Xur, Xur, Isa, Uu, Uu, Cud, Uu, Cud, Xu, Xu, Uu, Isa, Uu, Uu, Xu, Uu, Uu, Xu, Xu, Isa, Isa, Uu, Uu, Xu, Xu, Xu
Xu, Xu, Uu^Tf, Uh^Tf, Gll, Xuf, Xur, Xur, Uu, Isa, Uu, Xu, Xu, Cud, Xu, Xu, Uu, Uu, Isa, Isa, Uu, Xu, Uu, Uu, Xu, Isa, Uu, Uu, Xu, Xu, Xu, Xu, Xu
Xu, Xu, Xu, Rb, Sm, Xuf, Xu, Xur, Uu, Isa, Uu, Xu, Uu, Xu, Uu, Xu, Isa, Isa, Uu, Uu, Xu, Xu, Uu, Xu, Uu, Isa, Uu, Xu, Xu, Uu, Uu, Xu, Xu
Xu, Xu, Xuf, Sm, Uu^Tf, Sm, Uu^Tf, Xu, Uu, Isa, Uu, Xu, Uu, Uu, Xu, Xu, Isa, Uu, Xu, Xu, Uu, Xu, Xu, Xu, Uu, Isa, Uu, Xu, Xu, Uu, Uu, Xu, Xu
Xu, Xu, Xuf, Rb^Tf, Gll, Xu, Sm^Tf, Xu, Xu, Isa, Uu, Xu, Uu, Uu, Xu, Uu, Isa, Uu, Xu, Uu, Uu, Xu, Xu, Uu, Isa, Isa, Xu, Xu, Uu, Uu, Xu, Xu, Xu
Xu, Xu, Xu, Uu, Uh, Xu, Sm, Xu, Xu, Isa, Isa, Xu, Xu, Uu, Xu, Uu, Isa, Uu, Xu, Uu, Uu, Uu, Xu, Uu, Isa, Uu, Xu, Xu, Uu, Uu, Xu, Xu, Xu
Xu, Xu, Rb, Sm, Sm, Xu, Uu^Tf, Xu, Xu, Uu, Uu, Isa, Xu, Xu, Xu, Xu, Isa, Uu, Xu, Xu, Uu, Uu, Xu, Uu, Isa, Xu, Xu, Xu, Uu, Uu, Xu, Xu, Xu
Xu, Xuf, Uh, Uu, Xuf, Xu, Xuf, Xu, Xu, Uu, Uu, Uu, Isa, Xu, Xu, Xu, Isa, Uu, Uu, Xu, Xu, Xu, Xu, Uu, Isa, Xu, Xu, Uu, Xu, Uu, Uu, Xu, Xu
Xu, Xuf, Xuf, Gg, Xuf, Xuf, Gg^Fp, Xuf, Xuf, Xu, Xu, Uu, Isa, Xu, Xu, Xu, Isa, Uu, Uu, Xu, Xu, Xu, Xu, Uu, Uu, Isa, Isa, Xu, Xu, Uu, Xu, Xu, Xu
Xu, Xuf, Gs^Fp, Gg^Fds, Gs^Fp, Gg, Gg^Fet, Gs^Fp, Xuf, Xu, Xu, Uu, Isa, Xu, Xu, Xu, Isa, Uu, Xu, Xu, Uu, Uu, Uu, Xu, Xu, Uu, Isa, Uu, Xu, Xu, Xu, Xu, Xu
Xu, Xuf, Gg^Fp, Wwf^Ii, Wwf^Ii, Gs^Fp, Gs^Fds, Gg^Fds, Xu, Xu, Xu, Uu, Isa, Xu, Xu, Xu, Isa, Uu, Xu, Uu, Uu, Uu, Uu, Uu, Xu, Uu, Uu, Isa, Xu, Xu, Xu, Xu, Xu
Xu, Xuf, Gg^Fds, Gg^Fet, Gs^Fp, Wwf, Xuf, Xu, Xu, Xu, Uu, Uu, Isa, Uu, Xu, Xu, Isa, Uu, Xu, Uu, Uu, Uu, Uu, Uu, Xu, Xu, Uu, Isa, Uu, Xu, Xu, Xu, Xu
Xu, Xuf, Xuf, Gs, Wwf^Ii, Gg^Fp, Xuf, Xu, Uu, Uu, Isa, Isa, Uu, Uu, Xu, Xu, Uu, Isa, Xu, Uu, Uu, Uu, Uu, Uu, Xu, Xu, Uu, Isa, Uu, Xu, Xu, Xu, Xu
Xu, Xu, Xuf, Wwf^Ii, Gs^Fds, Gg^Fds, Xuf, Xu, Uu, Isa, Uu, Uu, Xu, Xu, Xu, Xu, Uu, Isa, Uu, Xu, Uu, Uu, Uu, Uu, Xu, Uu, Isa, Isa, Uu, Xu, Xu, Xu, Xu
Xuf, Xuf, Xuf, Wwf, Gs^Fp, Gg^Fet, Xuf, Xu, Xu, Isa, Uu, Xu, Uu, Uu, Xu, Uu, Uu, Isa, Uu, Xu, Xu, Uu, Uu, Uu, Xu, Uu, Isa, Uu, Ce, Uu, Uu, Xu, Uu
Qxu, Qxu, Qxu, Gg^Fp, Wwf^Ii, Gs, Gg^Fp, Xuf, Xu, Isa, Uu, Xu, Xu, Xu, Uu, Uu, Isa, Isa, Isa, Uu, Uu, Xu, Xu, Xu, Ce, Uu, Isa, Ce, Ket, Ce, Uu, Uu, Isa
Qxu, Qxu, Gg^Fet, Gg^Ii, Wwf, Gg^Fds, Ds^Esd, Xuf, Xu, Isa, Isa, Uu, Uu, Uu, Isa, Isa, Uu, Uu, Xu, Isa, Isa, Uu, Uu, Xu, Ce, Uu, Isa, Uu, Uu, Ce, Isa, Isa, Xu
Qxu, Qxu, Gs^Fp, Gs^Fds, Gs^Fp, Ds, Wwrg, Xuf, Xuf, Xu, Xu, Isa, Isa, Isa, Xu, Uu, Xu, Xu, Xu, Xu, Xu, Isa, Isa, Uu, Isa, Isa, Uu, Isa, Isa, Isa, Xu, Xu, Xu
Qxu, Qxu, Gg^Fp, Wwf^Ii, Ds^Esd, Ds^Esd, Wwg^Ii, Wog, Qxu, Xu, Xu, Xu, Xu, Xu, Xu, Xu, Xu, Xu, Xu, Xu, Xu, Uu, Uu, Isa, Uu, Uu, Ce, Uu, Uu, Uu, Xu, Xu, Xu
Qxu, Qxu, Qxu, Wwf^Esd, Wwrg, Wwg, Wog^Ii, Wog^Ii, Qxu, Qxu, Qxu, Qxu, Qxu, Xu, Xu, Xu, Xu, Xu, Xu, Xu, Xu, Xu, Xu, Uu, Xu, Xu, Xu, Xu, Xu, Xu, Xu, Xu, Xu
Qxu, Qxu, Qxu, Qxu, Qxu, Wog, Qxu, Qxu, Qxu, Qxu, Qxu, Qxu, Qxu, Xu, Xu, Xu, Xu, Xu, Xu, Xu, Xu, Xu, Xu, Xu, Xu, Xu, Xu, Xu, Xu, Xu, Xu, Xu, Xu
Qxu, Qxu, Qxu, Qxu, Qxu, Qxu, Qxu, Qxu, Xu, Xu, Xu, Qxu, Qxu, Xu, Xu, Xu, Xu, Xu, Xu, Xu, Xu, Xu, Xu, Xu, Xu, Xu, Xu, Xu, Xu, Xu, Xu, Xu, Xu
