Xu, Xu, Rb, Uu, Xu, Xu, Xu, Xu, Xu, Uu, Uu, Xu, Xu, Xu, Rb, Uu, Xu, Xu, Xu, Xu, Xu, Xu, Xu, Xu, Xu, Xu, Xu, Xu, Xu, Xu, Xu, Xu, Xu
Xu, Xu, Uu, Rb, Xu, Xu, Xu, Xu, Uu, Uu, Uu, Xu, Xu, Xu, Rb, Uu, Xu, Xu, Xu, Xu, Xu, Xu, Xu, Xu, Xu, Xu, Xu, Xu, Xu, Xu, Xu, Xu, Xu
Xu, Xu, Uu, Rb, Xu, Uu, Xu, Uu, Uu, Uu, Uu, Uu, Xu, Rb, Uu, Uu, Xu, Xu, Xu, Uu, Uu, Uu, Uu, Xu, Xu, Xu, Uu, Xu, Xu, Xu, Xu, Xu, Xu
Xu, Xu, Rb, Uu, Xu, Uu, Xu, Uu, Uu, Uu, Uu, Uu, Xu, Uu, Isa, Xu, Uu, Uu, Uu, Uu, Uu, Uu, Uu, Xu, Xu, Uu, Xu, Xu, Xu, Xu, Rb, Xu, Isa
Xu, Xu, Rb, Rb, Uu, Xu, Xu, Xu, Xu, Uu, Uu, Xu, Xu, Isa, Rb, Xu, Uu, Uu, Uu, Uu, Uu, Xu, Xu, Xu, Uu, Xu, Isa, Isa, Isa, Rb, Isa, Isa, Uu
Xu, Xu, Xu, Isa, Isa, Uu, Isa, Xu, Xu, Uu, Xu, Xu, Uu, Isa, Rb, Xu, Xu, Uu, Xu, Uu, Xu, Xu, Rb, Rb, Isa, Isa, Uu, Uu, Rb, Isa, Uu, Uu, Xu
Xu, Xu, Xu, Uu, Uu, Isa, Rb, Isa, Isa, Xu, Xu, Xu, Uu, Isa, Uu, Xu, Xu, Uu, Uu, Xu, Uu, Uu, Isa, Isa, Xu, Uu, Xu, Xu, Xu, Rb, Xu, Xu, Xu
Xu, Xu, Xu, Xu, Xu, Xu, Xu, Rb, Isa, Uu, Xu, Xu, Rb, Isa, Isa, Uu, Xu, Xu, Xu, Xu, Rb, Isa, Xu, Xu, Xu, Xu, Uu, Uu, Xu, Xu, Uu, Xu, Xu
Xu, Sm^Tf, Sm^Tf, Xu, Rb, Rb, Xu, Xu, Isa, Uu, Xu, Xu, Xu, Rb, Uu, Isa, Rb, Xu, Uu, Xu, Rb, Isa, Uu, Xu, Xu, Uu, Uu, Uu, Uu, Xu, Uu, Uu, Xu
Xu, Xu, Uu, Xu, Xuf, Xuf, Sm^Ii, Uu, Isa, Rb, Rb, Xu, Uu, Xu, Xu, Isa, Isa, Xu, Rb, Xu, Xu, Isa, Uu, Xu, Xu, Xu, Uu, Uu, Uu, Uu, Uu, Uu, Xu
Xu, Xu, Xuf, Uh, Sm^Dr, Uu^Tf, Rb^Tf, Sm^Dr, Xu, Isa, Uu, Xu, Uu, Uu, Xu, Rb, Isa, Rb, Ce, Rb, Ce, Isa, Isa, Uu, Xu, Xu, Xu, Uu, Uu, Uu, Uu, Xu, Xu
Xu, Xuf, Gll^Tfi, Sm, Sm^Ii, Rb^Ii, Xu, Xu, Xu, Isa, Uu, Xu, Xu, Xu, Uu, Rb, Isa, Uu, Ce, Ket, Ce, Rb, Isa, Rb, Rb, Xu, Xu, Xu, Uu, Uu, Uu, Xu, Xu
Xu, Xuf, Uu^Tf, Uu^Tf, Xuf, Xu, Xu, Xu, Isa, Isa, Isa, Rb, Rb, Uu, Isa, Isa, Rb, Isa, Isa, Rb, Isa, Isa, Uu, Isa, Isa, Isa, Isa, Xu, Xu, Uu, Xu, Xu, Xu
Xu, Xu, Sm^Dr, Uu^Ii, Xuf, Xu, Uu, Isa, Rb, Rb, Uu, Isa, Isa, Isa, Uu, Uu, Xu, Rb, Uu, Isa, Rb, Rb, Xu, Uu, Uu, Uu, Rb, Isa, Isa, Xu, Xu, Xu, Xu
Xu, Xu, Sm, Uh, Xu, Xu, Uu, Isa, Uu, Xu, Xu, Uu, Xu, Xu, Xu, Xu, Uu, Xu, Xu, Uu, Xu, Xu, Xu, Xu, Xu, Xu, Xu, Rb, Isa, Xu, Xu, Xu, Xu
Xu, Xuf, Uu^Tf, Sm^Tf, Xu, Xu, Rb, Isa, Uu, Xu, Xu, Xu, Uu, Uu, Xu, Xu, Xu, Uu, Xu, Xu, Uu, Uu, Uu, Uu, Uu, Xu, Xu, Rb, Isa, Uu, Xu, Xu, Xu
Xu, Xuf, Uu, Gll^Tfi, Xu, Xu, Rb, Isa, Isa, Uu, Xu, Xu, Xu, Uu, Uu, Uu, Uu, Xu, Xu, Uu, Uu, Uu, Uu, Uu, Uu, Uu, Xu, Xu, Isa, Uu, Uu, Xu, Xu
Xu, Xu, Sm, Gll^Ii, Xuf, Xu, Xu, Uu, Isa, Rb, Rb, Xu, Xu, Uu, Uu, Uu, Uu, Xu, Xu, Uu, Uu, Uu, Uu, Uu, Uu, Uu, Xu, Xu, Isa, Isa, Uu, Xu, Xu
Xu, Xu, Sm, Sm^Tf, Uh^Tf, Xuf, Xu, Uu, Isa, Uu, Rb, Xu, Xu, Uu, Xu, Uu, Xu, Xu, Uu, Uu, Uu, Uu, Uu, Uu, Uu, Uu, Uu, Xu, Xu, Isa, Rb, Xu, Xu
Xu, Xu, Xu, Uu^Ii, Gll^Ii, Xu, Xu, Rb, Isa, Cud, Uu, Uu, Uu, Xu, Xu, Xu, Xu, Xu, Uu, Uu, Uu, Uu, Xu, Uu, Xu, Uu, Xu, Xu, Xu, Isa, Rb, Xu, Xu
Xu, Xu, Xuf, Rb, Uu, Xu, Xu, Rb, Isa, Uu, Uu, Cud, Kud, Rb, Rb, Uu, Uu, Xu, Xu, Uu, Xu, Xu, Xu, Xu, Xu, Xu, Xu, Uu, Xu, Isa, Uu, Xu, Xu
Xu, Xuf, Uu^Tf, Sm, Sm, Sm, Uu, Xu, Isa, Rb, Rb, Cud, Cud, Cud, Uu, Cud, Uu, Xu, Xu, Xu, Uu, Xu, Isa, Isa, Isa, Rb, Isa, Xu, Isa, Isa, Uu, Xu, Xu
Xu, Xuf, Gll^Ii, Rb^Tf, Xu, Xu, Sm, Xu, Uu, Isa, Isa, Uu, Isa, Uu, Isa, Uu, Rb, Rb, Uu, Uu, Isa, Isa, Uu, Rb, Rb, Isa, Uu, Isa, Isa, Rb, Xu, Xu, Xu
Xu, Xu, Sm^Ii, Uu, Xu, Xu, Sm^Dr, Xu, Cud, Uu, Isa, Isa, Uu, Isa, Uu, Isa, Isa, Isa, Isa, Isa, Uu, Uu, Xu, Xu, Xu, Xu, Xu, Uu, Isa, Rb, Xu, Xu, Xu
Xu, Xu, Sm, Sm, Xuf, Xu, Uu^Dr, Xur, Xur, Isa, Rb, Rb, Cud, Uu, Cud, Xu, Xu, Uu, Isa, Uu, Uu, Xu, Uu, Uu, Xu, Xu, Isa, Isa, Uu, Uu, Xu, Xu, Xu
Xu, Xu, Uu^Tf, Uh^Tf, Gll^Ii, Xuf, Xur, Xur, Rb, Isa, Uu, Xu, Xu, Cud, Xu, Xu, Uu, Uu, Isa, Isa, Rb, Xu, Uu, Uu, Xu, Isa, Uu, Uu, Xu, Xu, Xu, Xu, Xu
Xu, Xu, Xu, Rb^Ii, Sm, Xuf, Xu, Xur, Rb, Isa, Uu, Xu, Uu, Xu, Uu, Xu, Isa, Isa, Uu, Rb, Xu, Xu, Uu, Xu, Uu, Isa, Rb, Xu, Xu, Uu, Uu, Xu, Xu
Xu, Xu, Xuf, Sm, Uu^Tf, Sm, Uu^Tf, Xu, Uu, Isa, Rb, Xu, Uu, Uu, Xu, Xu, Isa, Uu, Xu, Xu, Uu, Xu, Xu, Xu, Uu, Isa, Rb, Xu, Xu, Uu, Uu, Xu, Xu
Xu, Xu, Xuf, Rb^Tf, Gll^Ii, Xu, Sm^Tf, Xu, Xu, Isa, Rb, Xu, Uu, Uu, Xu, Uu, Isa, Rb, Xu, Uu, Uu, Xu, Xu, Rb, Isa, Isa, Xu, Xu, Uu, Uu, Xu, Xu, Xu
Xu, Xu, Xu, Uu^Ii, Uh, Xu, Sm, Xu, Xu, Isa, Isa, Xu, Xu, Uu, Xu, Uu, Isa, Rb, Xu, Uu, Uu, Uu, Xu, Rb, Isa, Uu, Xu, Xu, Uu, Uu, Xu, Xu, Xu
Xu, Xu, Rb, Sm, Sm, Xu, Uu^Tf, Xu, Xu, Rb, Uu, Isa, Xu, Xu, Uu, Xu, Isa, Uu, Xu, Xu, Uu, Uu, Xu, Uu, Isa, Xu, Xu, Xu, Uu, Uu, Xu, Xu, Xu
Xu, Xuf, Uh, Uu, Xuf, Xu, Xuf, Xu, Xu, Rb, Rb, Uu, Isa, Xu, Xu, Xu, Isa, Uu, Rb, Xu, Xu, Xu, Xu, Uu, Isa, Xu, Xu, Uu, Xu, Uu, Uu, Xu, Xu
Xu, Xuf, Xuf, Gg, Xuf, Xuf, Gg^Fp, Xuf, Xuf, Xu, Xu, Uu, Isa, Xu, Uu, Xu, Isa, Uu, Rb, Xu, Xu, Xu, Xu, Uu, Rb, Isa, Isa, Xu, Xu, Uu, Xu, Xu, Xu
Xu, Xuf, Gs^Fp, Gg^Fds, Gs^Fp, Gg, Gg^Fet, Gs^Fp, Xuf, Xu, Xu, Uu, Isa, Xu, Uu, Xu, Isa, Uu, Xu, Xu, Uu, Uu, Uu, Xu, Xu, Rb, Isa, Uu, Xu, Xu, Uu, Xu, Xu
Xu, Xuf, Gg^Fp, Wwf^Ii, Wwf^Ii, Gs^Fp, Gs^Fds, Gg^Fds, Xu, Xu, Xu, Rb, Isa, Xu, Xu, Xu, Isa, Rb, Xu, Uu, Uu, Uu, Uu, Uu, Xu, Rb, Uu, Isa, Xu, Uu, Uu, Xu, Xu
Xu, Xuf, Gg^Fds, Gg^Fet, Gs^Fp, Wwf, Xuf, Xu, Xu, Xu, Rb, Rb, Isa, Uu, Xu, Xu, Isa, Rb, Xu, Uu, Uu, Uu, Uu, Uu, Xu, Xu, Uu, Isa, Uu, Xu, Uu, Xu, Xu
Xu, Xuf, Xuf, Gs, Wwf^Ii, Gg^Fp, Xuf, Xu, Rb, Uu, Isa, Isa, Uu, Uu, Xu, Xu, Uu, Isa, Xu, Uu, Uu, Uu, Uu, Uu, Xu, Xu, Uu, Isa, Rb, Xu, Uu, Xu, Xu
Xu, Xu, Xuf, Wwf^Ii, Gs^Fds, Gg^Fds, Xuf, Xu, Rb, Isa, Uu, Uu, Xu, Xu, Xu, Xu, Rb, Isa, Uu, Xu, Uu, Uu, Uu, Uu, Xu, Rb, Isa, Isa, Rb, Xu, Xu, Uu, Xu
Xuf, Xuf, Xuf, Wwf, Gs^Fp, Gg^Fet, Xuf, Xu, Xu, Isa, Rb, Xu, Uu, Uu, Xu, Uu, Rb, Isa, Uu, Xu, Xu, Uu, Uu, Uu, Xu, Rb, Isa, Uu, Ce, Rb, Uu, Xu, Rb
Qxu, Qxu, Qxu, Gg^Fp, Wwf^Ii, Gs, Gg^Fp, Xuf, Xu, Isa, Rb, Xu, Xu, Xu, Rb, Uu, Isa, Isa, Isa, Uu, Rb, Xu, Xu, Xu, Ce, Uu, Isa, Ce, Ket, Ce, Uu, Rb, Isa
Qxu, Qxu, Gg^Fet, Gg^Ii, Wwf, Gg^Fds, Ds^Esd, Xuf, Xu, Isa, Isa, Uu, Uu, Rb, Isa, Isa, Rb, Rb, Xu, Isa, Isa, Rb, Uu, Uu, Ce, Uu, Isa, Uu, Uu, Ce, Isa, Isa, Xu
Qxu, Qxu, Gs^Fp, Gs^Fds, Gs^Fp, Ds, Wwrg, Xuf, Xuf, Xu, Xu, Isa, Isa, Isa, Xu, Uu, Xu, Xu, Uu, Xu, Xu, Isa, Isa, Uu, Isa, Isa, Rb, Isa, Isa, Isa, Xu, Xu, Xu
Qxu, Qxu, Gg^Fp, Wwf^Ii, Ds^Esd, Ds^Esd, Wwg^Ii, Wog, Qxu, Xu, Xu, Xu, Xu, Xu, Uu, Xu, Uu, Xu, Uu, Uu, Xu, Uu, Rb, Isa, Uu, Uu, Ce, Rb, Uu, Uu, Xu, Xu, Xu
Qxu, Qxu, Qxu, Wwf^Esd, Wwrg, Wwg, Wog^Ii, Wog^Ii, Qxu, Qxu, Qxu, Qxu, Qxu, Xu, Uu, Uu, Uu, Uu, Xu, Uu, Xu, Xu, Xu, Rb, Xu, Xu, Xu, Xu, Xu, Xu, Xu, Xu, Xu
Qxu, Qxu, Qxu, Qxu, Qxu, Wog, Qxu, Qxu, Qxu, Qxu, Qxu, Qxu, Qxu, Xu, Xu, Xu, Xu, Uu, Xu, Xu, Xu, Xu, Xu, Xu, Xu, Xu, Xu, Xu, Xu, Xu, Xu, Xu, Xu
Qxu, Qxu, Qxu, Qxu, Qxu, Qxu, Qxu, Qxu, Xu, Xu, Xu, Qxu, Qxu, Xu, Xu, Xu, Xu, Xu, Xu, Xu, Xu, Xu, Xu, Xu, Xu, Xu, Xu, Xu, Xu, Xu, Xu, Xu, Xu
