Xu, Xu, Uu, Uu, Xu, Xu, Xu, Xu, Xu, Xu, Xu, Xu, Xu, Xu, Uu, Uu, Xu, Xu, Xu, Xu, Xu, Xu, Xu, Xu, Xu, Xu, Xu, Xu, Xu, Xu, Xu, Xu, Xu
Xu, Xu, Uu, Uu, Xu, Xu, Xu, Xu, Xu, Xu, Xu, Xu, Xu, Xu, Uu, Uu, Xu, Xu, Xu, Xu, Xu, Xu, Xu, Xu, Xu, Xu, Xu, Xu, Xu, Xu, Xu, Xu, Xu
Xu, Xu, Uu, Uu, Xu, Xu, Xu, Xu, Xu, Xu, Xu, Xu, Xu, Uu, Uu, Uu, Xu, Xu, Xu, Xu, Xu, Xu, Xu, Xu, Xu, Xu, Xu, Xu, Xu, Xu, Xu, Xu, Xu
Xu, Xu, Uu, Uu, Xu, Xu, Xu, Xu, Xu, Xu, Xu, Xu, Xu, Uu, Ur, Xu, Xu, Xu, Xu, Xu, Xu, Xu, Xu, Xu, Xu, Xu, Xu, Xu, Xu, Xu, Uu, Xu, Ur
Xu, Xu, Uu, Uu, Uu, Xu, Xu, Xu, Xu, Xu, Xu, Xu, Xu, Ur, Uu, Xu, Xu, Xu, Xu, Xu, Xu, Xu, Xu, Xu, Uu, Xu, Ur, Ur, Ur, Uu, Ur, Ur, Uu
Xu, Xu, Xu, Ur, Ur, Uu, Ur, Xu, Xu, Xu, Xu, Xu, Uu, Ur, Uu, Xu, Xu, Xu, Xu, Xu, Xu, Xu, Uu, Uu, Ur, Ur, Uu, Uu, Uu, Ur, Uu, Uu, Xu
Xu, Xu, Xu, Uu, Uu, Ur, Uu, Ur, Ur, Xu, Xu, Xu, Uu, Ur, Uu, Xu, Xu, Xu, Xu, Xu, Uu, Uu, Ur, Ur, Xu, Uu, Xu, Xu, Xu, Uu, Xu, Xu, Xu
Xu, Xu, Xu, Xu, Xu, Xu, Xu, Uu, Ur, Uu, Xu, Xu, Uu, Ur, Ur, Uu, Xu, Xu, Xu, Xu, Uu, Ur, Xu, Xu, Xu, Xu, Xu, Xu, Xu, Xu, Xu, Xu, Xu
Xu, Sm^Tf, Sm^Tf, Xu, Xu, Xu, Xu, Xu, Ur, Uu, Xu, Xu, Xu, Uu, Uu, Ur, Uu, Xu, Xu, Xu, Uu, Ur, Uu, Xu, Xu, Xu, Xu, Xu, Xu, Xu, Xu, Xu, Xu
Xu, Xu, Uu, Xu, Xuf, Xuf, Sm, Uu, Ur, Uu, Uu, Xu, Xu, Xu, Xu, Ur, Ur, Xu, Xu, Xu, Xu, Ur, Uu, Xu, Xu, Xu, Xu, Xu, Xu, Xu, Xu, Xu, Xu
Xu, Xu, Xuf, Uh, Sm, Uu^Tf, Rb^Tf, Sm, Xu, Ur, Uu, Xu, Xu, Xu, Xu, Uu, Ur, Uu, Ce, Xu, Ce, Ur, Ur, Uu, Xu, Xu, Xu, Xu, Xu, Xu, Xu, Xu, Xu
Xu, Xuf, Gll^Tf, Sm, Sm, Rb, Xu, Xu, Xu, Ur, Uu, Xu, Xu, Xu, Uu, Uu, Ur, Uu, Ce, Ket, Ce, Uu, Ur, Uu, Uu, Xu, Xu, Xu, Xu, Xu, Xu, Xu, Xu
Xu, Xuf, Uu^Tf, Uu^Tf, Xuf, Xu, Xu, Xu, Ur, Ur, Ur, Uu, Uu, Uu, Ur, Ur, Uu, Ur, Ur, Uu, Ur, Ur, Uu, Ur, Ur, Ur, Ur, Xu, Xu, Xu, Xu, Xu, Xu
Xu, Xu, Sm, Uu, Xuf, Xu, Uu, Ur, Uu, Uu, Uu, Ur, Ur, Ur, Uu, Uu, Xu, Uu, Uu, Ur, Uu, Uu, Xu, Uu, Uu, Uu, Uu, Ur, Ur, Xu, Xu, Xu, Xu
Xu, Xu, Sm, Uh, Xu, Xu, Uu, Ur, Uu, Xu, Xu, Uu, Xu, Xu, Xu, Xu, Xu, Xu, Xu, Uu, Xu, Xu, Xu, Xu, Xu, Xu, Xu, Uu, Ur, Xu, Xu, Xu, Xu
Xu, Xuf, Uu^Tf, Sm^Tf, Xu, Xu, Uu, Ur, Uu, Xu, Xu, Xu, Xu, Xu, Xu, Xu, Xu, Xu, Xu, Xu, Xu, Xu, Xu, Xu, Xu, Xu, Xu, Uu, Ur, Uu, Xu, Xu, Xu
Xu, Xuf, Uu, Gll^Tf, Xu, Xu, Uu, Ur, Ur, Uu, Xu, Xu, Xu, Xu, Xu, Xu, Xu, Xu, Xu, Xu, Xu, Xu, Xu, Xu, Xu, Xu, Xu, Xu, Ur, Uu, Uu, Xu, Xu
Xu, Xu, Sm, Gll, Xuf, Xu, Xu, Uu, Ur, Uu, Uu, Xu, Xu, Xu, Xu, Xu, Xu, Xu, Xu, Xu, Xu, Xu, Xu, Xu, Xu, Xu, Xu, Xu, Ur, Ur, Uu, Xu, Xu
Xu, Xu, Sm, Sm^Tf, Uh^Tf, Xuf, Xu, Uu, Ur, Uu, Uu, Xu, Xu, Xu, Xu, Xu, Xu, Xu, Xu, Xu, Xu, Xu, Xu, Xu, Xu, Xu, Xu, Xu, Xu, Ur, Uu, Xu, Xu
Xu, Xu, Xu, Uu, Gll, Xu, Xu, Uu, Ur, Cud, Uu, Uu, Uu, Xu, Xu, Xu, Xu, Xu, Xu, Xu, Xu, Xu, Xu, Xu, Xu, Xu, Xu, Xu, Xu, Ur, Uu, Xu, Xu
Xu, Xu, Xuf, Rb, Uu, Xu, Xu, Uu, Ur, Uu, Uu, Cud, Kud, Uu, Uu, Uu, Uu, Xu, Xu, Xu, Xu, Xu, Xu, Xu, Xu, Xu, Xu, Xu, Xu, Ur, Uu, Xu, Xu
Xu, Xuf, Uu^Tf, Sm, Sm, Sm, Uu, Xu, Ur, Uu, Uu, Cud, Cud, Cud, Uu, Cud, Uu, Xu, Xu, Xu, Uu, Xu, Ur, Ur, Ur, Uu, Ur, Xu, Ur, Ur, Uu, Xu, Xu
Xu, Xuf, Gll, Rb^Tf, Xu, Xu, Sm, Xu, Uu, Ur, Ur, Uu, Ur, Uu, Ur, Uu, Uu, Uu, Uu, Uu, Ur, Ur, Uu, Uu, Uu, Ur, Uu, Ur, Ur, Uu, Xu, Xu, Xu
Xu, Xu, Sm, Uu, Xu, Xu, Sm, Xu, Cud, Uu, Ur, Ur, Uu, Ur, Uu, Ur, Ur, Ur, Ur, Ur, Uu, Uu, Xu, Xu, Xu, Xu, Xu, Uu, Ur, Uu, Xu, Xu, Xu
Xu, Xu, Sm, Sm, Xuf, Xu, Uu, Xu, Xu, Ur, Uu, Uu, Cud, Uu, Cud, Xu, Xu, Uu, Ur, Uu, Uu, Xu, Xu, Xu, Xu, Xu, Ur, Ur, Uu, Uu, Xu, Xu, Xu
Xu, Xu, Uu^Tf, Uh^Tf, Gll, Xuf, Xu, Xu, Uu, Ur, Uu, Xu, Xu, Cud, Xu, Xu, Uu, Uu, Ur, Ur, Uu, Xu, Xu, Xu, Xu, Ur, Uu, Uu, Xu, Xu, Xu, Xu, Xu
Xu, Xu, Xu, Rb, Sm, Xuf, Xu, Xu, Uu, Ur, Uu, Xu, Xu, Xu, Xu, Xu, Ur, Ur, Uu, Uu, Xu, Xu, Xu, Xu, Uu, Ur, Uu, Xu, Xu, Xu, Xu, Xu, Xu
Xu, Xu, Xuf, Sm, Uu^Tf, Sm, Uu^Tf, Xu, Uu, Ur, Uu, Xu, Xu, Xu, Xu, Xu, Ur, Uu, Xu, Xu, Xu, Xu, Xu, Xu, Uu, Ur, Uu, Xu, Xu, Xu, Xu, Xu, Xu
Xu, Xu, Xuf, Rb^Tf, Gll, Xu, Sm^Tf, Xu, Xu, Ur, Uu, Xu, Xu, Xu, Xu, Uu, Ur, Uu, Xu, Xu, Xu, Xu, Xu, Uu, Ur, Ur, Xu, Xu, Xu, Xu, Xu, Xu, Xu
Xu, Xu, Xu, Uu, Uh, Xu, Sm, Xu, Xu, Ur, Ur, Xu, Xu, Xu, Xu, Uu, Ur, Uu, Xu, Xu, Xu, Xu, Xu, Uu, Ur, Uu, Xu, Xu, Xu, Xu, Xu, Xu, Xu
Xu, Xu, Rb, Sm, Sm, Xu, Uu^Tf, Xu, Xu, Uu, Uu, Ur, Xu, Xu, Xu, Xu, Ur, Uu, Xu, Xu, Xu, Xu, Xu, Uu, Ur, Xu, Xu, Xu, Xu, Xu, Xu, Xu, Xu
Xu, Xuf, Uh, Uu, Xuf, Xu, Xuf, Xu, Xu, Uu, Uu, Uu, Ur, Xu, Xu, Xu, Ur, Uu, Uu, Xu, Xu, Xu, Xu, Uu, Ur, Xu, Xu, Xu, Xu, Xu, Xu, Xu, Xu
Xu, Xuf, Xuf, Gg, Xuf, Xuf, Gg^Fp, Xuf, Xuf, Xu, Xu, Uu, Ur, Xu, Xu, Xu, Ur, Uu, Uu, Xu, Xu, Xu, Xu, Uu, Uu, Ur, Ur, Xu, Xu, Xu, Xu, Xu, Xu
Xu, Xuf, Gs^Fp, Gg^Fds, Gs^Fp, Gg, Gg^Fet, Gs^Fp, Xuf, Xu, Xu, Uu, Ur, Xu, Xu, Xu, Ur, Uu, Xu, Xu, Xu, Xu, Xu, Xu, Xu, Uu, Ur, Uu, Xu, Xu, Xu, Xu, Xu
Xu, Xuf, Gg^Fp, Wwf^Ii, Wwf^Ii, Gs^Fp, Gs^Fds, Gg^Fds, Xu, Xu, Xu, Uu, Ur, Xu, Xu, Xu, Ur, Uu, Xu, Xu, Xu, Xu, Xu, Xu, Xu, Uu, Uu, Ur, Xu, Xu, Xu, Xu, Xu
Xu, Xuf, Gg^Fds, Gg^Fet, Gs^Fp, Wwf, Xuf, Xu, Xu, Xu, Uu, Uu, Ur, Uu, Xu, Xu, Ur, Uu, Xu, Xu, Xu, Xu, Xu, Xu, Xu, Xu, Uu, Ur, Uu, Xu, Xu, Xu, Xu
Xu, Xuf, Xuf, Gs, Wwf^Ii, Gg^Fp, Xuf, Xu, Uu, Uu, Ur, Ur, Uu, Uu, Xu, Xu, Uu, Ur, Xu, Xu, Xu, Xu, Xu, Xu, Xu, Xu, Uu, Ur, Uu, Xu, Xu, Xu, Xu
Xu, Xu, Xuf, Wwf^Ii, Gs^Fds, Gg^Fds, Xuf, Xu, Uu, Ur, Uu, Uu, Xu, Xu, Xu, Xu, Uu, Ur, Uu, Xu, Xu, Xu, Xu, Xu, Xu, Uu, Ur, Ur, Uu, Xu, Xu, Xu, Xu
Xuf, Xuf, Xuf, Wwf, Gs^Fp, Gg^Fet, Xuf, Xu, Xu, Ur, Uu, Xu, Xu, Xu, Xu, Uu, Uu, Ur, Uu, Xu, Xu, Xu, Xu, Xu, Xu, Uu, Ur, Uu, Ce, Uu, Uu, Xu, Uu
Qxu, Qxu, Qxu, Gg^Fp, Wwf^Ii, Gs, Gg^Fp, Xuf, Xu, Ur, Uu, Xu, Xu, Xu, Uu, Uu, Ur, Ur, Ur, Uu, Uu, Xu, Xu, Xu, Ce, Uu, Ur, Ce, Ket, Ce, Uu, Uu, Ur
Qxu, Qxu, Gg^Fet, Gg^Ii, Wwf, Gg^Fds, Ds^Esd, Xuf, Xu, Ur, Ur, Uu, Uu, Uu, Ur, Ur, Uu, Uu, Xu, Ur, Ur, Uu, Uu, Xu, Ce, Uu, Ur, Uu, Uu, Ce, Ur, Ur, Xu
Qxu, Qxu, Gs^Fp, Gs^Fds, Gs^Fp, Ds, Wwrg, Xuf, Xuf, Xu, Xu, Ur, Ur, Ur, Xu, Uu, Xu, Xu, Xu, Xu, Xu, Ur, Ur, Uu, Ur, Ur, Uu, Ur, Ur, Ur, Xu, Xu, Xu
Qxu, Qxu, Gg^Fp, Wwf^Ii, Ds^Esd, Ds^Esd, Wwg^Ii, Wog, Qxu, Xu, Xu, Xu, Xu, Xu, Xu, Xu, Xu, Xu, Xu, Xu, Xu, Uu, Uu, Ur, Uu, Uu, Ce, Uu, Uu, Uu, Xu, Xu, Xu
Qxu, Qxu, Qxu, Wwf^Esd, Wwrg, Wwg, Wog^Ii, Wog^Ii, Qxu, Qxu, Qxu, Qxu, Qxu, Xu, Xu, Xu, Xu, Xu, Xu, Xu, Xu, Xu, Xu, Uu, Xu, Xu, Xu, Xu, Xu, Xu, Xu, Xu, Xu
Qxu, Qxu, Qxu, Qxu, Qxu, Wog, Qxu, Qxu, Qxu, Qxu, Qxu, Qxu, Qxu, Xu, Xu, Xu, Xu, Xu, Xu, Xu, Xu, Xu, Xu, Xu, Xu, Xu, Xu, Xu, Xu, Xu, Xu, Xu, Xu
Qxu, Qxu, Qxu, Qxu, Qxu, Qxu, Qxu, Qxu, Xu, Xu, Xu, Qxu, Qxu, Xu, Xu, Xu, Xu, Xu, Xu, Xu, Xu, Xu, Xu, Xu, Xu, Xu, Xu, Xu, Xu, Xu, Xu, Xu, Xu
