Qxu, Qxu, Qxu, Qxu, Qxu, Qxu, Qxu, Qxu, Qxu, Qxu, Qxu, Qxu, Qxu, Qxu, Qxu, Qxu, Qxu, Qxu, Qxu, Qxu, Xoa, Qxu, Xoa, Xoa, Xoa, Qxu, Xoa, Qxu, Qxu, Qxu, Qxu, Qxu, Qxu, Qxu, Qxu, Qxu, Qxu, Qxu, Qxu, Qxu, Qxu, Qxu, Qxu, Qxu, Qxu, Qxu
Qxu, Qxu, Qxu, Qxu, Qxu, Qxu, Qxu, Qxu, Qxu, Qxu, Qxu, Qxu, Qxu, Qxu, Qxu, Qxu, Qxu, Qxu, Xoa, Xoa, Cud^Ebn, Qxu, Qxu, Xoa, Qxu, Qxu, Cud^Ebn, Xoa, Xoa, Qxu, Qxu, Qxu, Qxu, Qxu, Qxu, Qxu, Qxu, Qxu, Qxu, Qxu, Qxu, Qxu, Qxu, Qxu, Qxu, Qxu
Qxu, Qxu, Qxu, Qxu, Qxu, Qxu, Qxu, Qxu, Qxu, Qxu, Qxu, Qxu, Qxu, Qxu, Qxu, Qxu, Qxu, Xoa, Cud, Cud, Qxu, Qxu, Qxu, Qxu, Qxu, Qxu, Qxu, Cud, Cud, Xoa, Qxu, Qxu, Qxu, Qxu, Qxu, Qxu, Qxu, Qxu, Qxu, Qxu, Qxu, Qxu, Qxu, Qxu, Qxu, Qxu
Qxu, Qxu, Qxu, Qxu, Qxu, Qxu, Qxu, Qxu, Qxu, Qxu, Qxu, Qxu, Qxu, Qxu, Qxu, Qxu, Qxu, Xoa, Cud, Qxu, Qxu, Qxu, Xoa, Xoa, Xoa, Qxu, Qxu, Qxu, Cud, Xoa, Qxu, Qxu, Qxu, Qxu, Qxu, Qxu, Qxu, Qxu, Qxu, Qxu, Qxu, Qxu, Qxu, Qxu, Qxu, Qxu
Qxu, Qxu, Qxu, Qxu, Qxu, Qxu, Qxu, Qxu, Qxu, Qxu, Qxu, Qxu, Qxu, Qxu, Qxu, Qxu, Qxu, Xoa, Cud^Ebn, Qxu, Qxu, Xoa, Xu, Xu, Xu, Xoa, Qxu, Qxu, Cud^Ebn, Xoa, Qxu, Qxu, Qxu, Qxu, Qxu, Qxu, Qxu, Qxu, Qxu, Qxu, Qxu, Qxu, Qxu, Qxu, Qxu, Qxu
Qxu, Qxu, Qxu, Qxu, Qxu, Qxu, Qxu, Qxu, Qxu, Qxu, Qxu, Qxu, Qxu, Qxu, Qxu, Qxu, Qxu, Xoa, Qxu, Qxu, Qxu, Xoa, Xu, Xu, Xu, Xoa, Qxu, Qxu, Qxu, Xoa, Qxu, Qxu, Qxu, Qxu, Qxu, Qxu, Qxu, Qxu, Qxu, Qxu, Qxu, Qxu, Qxu, Qxu, Qxu, Qxu
Qxu, Qxu, Qxu, Qxu, Qxu, Qxu, Qxu, Qxu, Qxu, Qxu, Qxu, Qxu, Qxu, Qxu, Qxu, Qxu, Qxu, Qxu, Qxu, Qxu, Qxu, Xoa, Xoa, Xu, Xoa, Xoa, Qxu, Qxu, Qxu, Qxu, Qxu, Qxu, Qxu, Qxu, Qxu, Qxu, Qxu, Qxu, Qxu, Qxu, Qxu, Qxu, Qxu, Qxu, Qxu, Qxu
Qxu, Qxu, Qxu, Qxu, Qxu, Qxu, Qxu, Qxu, Qxu, Qxu, Qxu, Qxu, Qxu, Qxu, Qxu, Qxu, Xoa, Xoa, Xoa, Qxu, Qxu, Qxu, Qxu, Xoa, Qxu, Qxu, Qxu, Qxu, Xoa, Xoa, Xoa, Qxu, Qxu, Qxu, Qxu, Qxu, Qxu, Qxu, Qxu, Qxu, Qxu, Qxu, Qxu, Qxu, Qxu, Qxu
Qxu, Qxu, Qxu, Qxu, Qxu, Qxu, Qxu, Qxu, Qxu, Qxu, Qxu, Qxu, Qxu, Qxu, Qxu, Qxu, Xoa, Xoa, Xoa, Qxu, Qxu, Qxu, Qxu, Qxu, Qxu, Qxu, Qxu, Qxu, Xoa, Xoa, Xoa, Qxu, Qxu, Qxu, Qxu, Qxu, Qxu, Qxu, Qxu, Qxu, Qxu, Qxu, Qxu, Qxu, Qxu, Qxu
Qxu, Qxu, Qxu, Qxu, Qxu, Qxu, Qxu, Qxu, Qxu, Qxu, Qxu, Qxu, Qxu, Qxu, Qxu, Qxu, Qxu, Xoa, Qxu, Qxu, Xoa, Cud^Ebn, Cud, Qxu, Cud, Cud^Ebn, Xoa, Qxu, Qxu, Xoa, Qxu, Qxu, Qxu, Qxu, Qxu, Qxu, Qxu, Qxu, Qxu, Qxu, Qxu, Qxu, Qxu, Qxu, Qxu, Qxu
Qxu, Qxu, Qxu, Qxu, Qxu, Qxu, Qxu, Qxu, Qxu, Qxu, Cud, Qxu, Qxu, Qxu, Qxu, Qxu, Qxu, Qxu, Qxu, Qxu, Qxu, Xoa, Xoa, Cud, Xoa, Xoa, Qxu, Qxu, Qxu, Qxu, Qxu, Qxu, Qxu, Qxu, Qxu, Qxu, Qxu, Qxu, Qxu, Qxu, Qxu, Qxu, Qxu, Qxu, Qxu, Qxu
Qxu, Qxu, Qxu, Qxu, Qxu, Qxu, Xu, Xoa, Xoa, Cud, Isa, Isa, Isa, Qxu, Cud, Cud, Cud, Qxu, Qxu, Qxu, Qxu, Qxu, Qxu, Xoa, Qxu, Qxu, Qxu, Qxu, Qxu, Qxu, Qxu, Qxu, Qxu, Qxu, Cud, Qxu, Qxu, Qxu, Cud, Qxu, Qxu, Qxu, Qxu, Qxu, Qxu, Qxu
Qxu, Qxu, Qxu, Qxu, Qxu, Xu, Xu, Xu, Xoa, Cud, Isa, Cud, Isa, Isa, Isa, Isa, Isa, Qxu, Qxu, Qxu, Qxu, Qxu, Qxu, Qxu, Qxu, Qxu, Qxu, Qxu, Qxu, Qxu, Isa, Qxu, Isa, Cud, Isa, Cud, Isa, Isa, Isa, Cud, Cud, Qxu, Qxu, Qxu, Qxu, Qxu
Qxu, Qxu, Qxu, Qxu, Xu, Xu, Xu, Xu, Xoa, Cud, Isa, Isa, Uu^Vud, Uu^Vud, Isa, Isa, Isa, Cud, Isa, Qxu, Cud, Qxu, Qxu, Qxu, Qxu, Qxu, Cud, Qxu, Isa, Isa, Isa, Isa, Isa, Isa, Isa, Isa, Uu^Vud, Uu^Vud, Isa, Isa, Cud, Qxu, Qxu, Qxu, Qxu, Qxu
Qxu, Qxu, Qxu, Qxu, Xu, Xu, Xoa, Xoa, Cud, Cud, Isa, Uu^Vud, Isa, Isa, Uu^Vud, Uu^Vud, Isa, Isa, Isa, Cud, Kud, Cud, Urc, Urc, Urc, Cud, Kud, Cud, Isa, Isa, Uu^Vud, Uu^Vud, Isa, Isa, Isa, Uu^Vud, Isa, Isa, Uu^Vud, Isa, Isa, Cud, Xoa, Xoa, Xu, Qxu
Qxu, Qxu, Qxu, Xu, Xu, Xu, Xoa, Kud, Cud, Isa, Isa, Isa, Isa, Uu^Vud, Isa, Isa, Uu^Vud, Uu^Vud, Isa, Cud, Cud, Cud, Urc, Urc, Urc, Cud, Cud, Cud, Isa, Uu^Vud, Isa, Isa, Uu^Vud, Uu^Vud, Isa, Isa, Isa, Uu^Vud, Uu^Vud, Uu^Vud, Isa, Cud, Xoa, Xu, Xu, Xu
Qxu, Qxu, Qxu, Xu, Xu, Xu, Xoa, Cud, Isa, Isa, Uu^Vud, Uu^Vud, Isa, Isa, Isa, Uu^Vud, Isa, Isa, Isa, Isa, Isa, Isa, Urc, Urc, Urc, Isa, Isa, Isa, Uu^Vud, Isa, Isa, Uu^Vud, Isa, Isa, Uu^Vud, Uu^Vud, Isa, Isa, Isa, Isa, Cud, Cud, Xoa, Xu, Xu, Xu
Qxu, Qxu, Xu, Xu, Xu, Xu, Xoa, Cud, Isa, Uu^Vud, Isa, Isa, Uu^Vud, Uu^Vud, Isa, Isa, Isa, Uu^Vud, Uu^Vud, Isa, Isa, Isa, Urc, Urc, Urc, Isa, Isa, Uu^Vud, Uu^Vud, Uu^Vud, Isa, Isa, Isa, Uu^Vud, Isa, Isa, Uu^Vud, Uu^Vud, Isa, Cud, Kud, Xoa, Xu, Xu, Xu, Xu
Qxu, Qxu, Xu, Xu, Xu, Xu, Xoa, Cud, Cud, Isa, Isa, Uu^Vud, Isa, Isa, Isa, Uu^Vud, Uu^Vud, Isa, Isa, Uu^Vud, Isa, Isa, Urc, Urc, Urc, Isa, Isa, Isa, Isa, Isa, Isa, Uu^Vud, Uu^Vud, Isa, Isa, Uu^Vud, Isa, Isa, Isa, Cud, Xoa, Xoa, Xu, Xu, Xu, Xu
Qxu, Xu, Xu, Xu, Xu, Xu, Xu, Xoa, Xoa, Cud, Cud, Isa, Cud, Cud, Cud, Isa, Isa, Uu^Vud, Isa, Isa, Isa, Isa, Cud, Urc, Cud, Isa, Cud, Isa, Isa, Isa, Isa, Isa, Isa, Uu^Vud, Isa, Isa, Cud, Isa, Cud, Cud, Xoa, Xu, Xof, Xu, Xu, Xu
Xu, Xu, Xu, Xu, Xof, Xof, Xof, Xu, Xu, Xoa, Xoa, Cud, Xoa, Xoa, Xoa, Cud, Xoa, Isa, Cud, Cud, Cud, Cud, Cud, Cud, Qxu^Bh|, Cud, Cud, Cud, Cud, Isa, Xoa, Cud, Cud, Isa, Cud, Cud, Xoa, Cud, Xoa, Xoa, Xof, Xof, Ur, Xof, Xof, Xu
Xu, Xu, Xu, Xof, Ur, Ur, Ur, Xof, Xu, Xu, Xu, Xoa, Xu, Xu, Xu, Xoa, Xu, Xoa, Qxu, Cud, Qxu^Bh|, Qxu^Bh|, Qxu^Bh|, Qxu^Bh|, Qxu^Bh|, Qxu^Bh|, Qxu^Bh|, Qxu, Qxu, Xoa, Xu, Xoa, Xoa, Cud, Xoa, Xoa, Xu, Xoa, Xoa, Xu, Xof^Efs, Ur, Ur^Ebn, Ur, Xof, Xu
Xu, Xu, Xu, Xof, Ur, Ur^Ebn, Ur, Xof^Efs, Xoa, Xoa, Xoa^Efs, Xu, Xu, Xu, Xu, Xu, Xu, Qxu, Qxu, Qxu^Bh|, Qxu^Bh|, Qxu^Bh|, Qxu^Bh|, Qxu^Bh|, Qxu^Bh|, Qxu^Bh|, Qxu^Bh|, Qxu, Qxu, Qxu, Xu, Xu, Xu, Xoa, Xu, Xu, Xoa^Efs, Xoa, Uh^Vud, Xoa, Cud, Ur, Ur, Ur, Xof, Xu
Xu, Xu, Xu, Xof, Xof, Ur, Kud, Cud, Uh, Uh^Tf, Isa, Cud, Wog, Xu, Xu, Xu, Qxu, Qxu, Qxu, Qxu^Bh|, Isa, Qxu^Bh|, Isa, Qxu^Bh|, Isa, Isa, Uu^Tf, Qxu, Qxu, Qxu, Xu, Xu, Uh, Xu^Efs, Cud, Xoa, Isa, Isa^Edt, Isa^Edt, Uh, Cud, Kud, Cud, Xof, Xu, Xu
Xu, Xu, Xu, Xu, Xoa^Efs, Cud, Cud, Cud, Isa, Uu^Vud, Isa, Wwg, Wwg, Wog, Xu, Xu, Qxu, Qxu, Xuc, Isa, Isa, Isa, Isa, Uu, Uh, Cud, Cud, Qxu, Qxu, Qxu, Wog, Uh^Tf, Wog, Cud, Wwg, Cud, Cud, Uu^Em, Isa^Edt, Uu^Edt, Isa, Cud, Uu^Tf, Xoa, Xu, Xu
Xu, Xu, Xu, Xoa, Isa, Uh^Tf, Uu^Tf, Uu^Em, Isa, Uu^Em, Xoa^Efs, Cud, Cud, Wog, Wwg, Cud, Qxu, Qxu, Xuc, Uu^Tf, Isa, Uu, Uh, Cud, Cud, Cud, Qxu, Qxu, Qxu, Qxu, Qxu, Wog, Wog, Wwg, Wwg, Wwg, Cud, Uh^Tf, Uu^Tf, Isa, Uu^Em, Isa^Edt, Isa^Edt, Xoa, Xu, Xu
Xu, Xu, Xu, Xoa, Isa^Em, Uu^Vud, Uh, Isa, Isa, Uh, Uh^Tf, Xoa, Cud, Wwg, Wwg, Cud, Qxu, Qxu, Qxu, Xuc, Isa, Cud, Cud, Cud, Uu, Isa, Qxu, Qxu, Qxu, Qxu, Xu, Wog, Wwg, Wwg, Xu, Wwg, Cud, Cud, Xoa, Isa, Uu^Tf, Uh^Vud, Xoa, Xoa, Xu, Xu
Xu, Xu, Xu, Xoa, Cud, Isa, Cud, Xoa, Xoa, Uu^Tf, Isa, Xoa^Efs, Xoa, Wog, Wwg, Wog, Qxu, Qxu, Qxu, Qxu, Isa, Cud, Uu, Uu^Tf, Uh, Isa, Xur, Qxu, Qxu, Qxu, Xu, Cud, Wwg, Cud, Xu, Xu, Xu, Xu, Xoa^Efs, Isa, Isa, Xoa, Xu, Xu, Xu, Xu
Xu, Xu, Xu, Xu, Xu, Wog, Wwg, Xoa^Efs, Xoa, Isa^Em, Uu^Tf, Uu, Xoa^Efs, Cud, Wwg, Xu, Xu, Qxu, Qxu, Qxu, Isa, Isa, Isa, Uh, Isa, Isa, Uu^Tf, Xur, Qxu, Qxu, Qxu, Xu^Efs, Wwg, Xu, Xu, Xu, Xu, Xu, Uh, Uu^Em, Isa, Xoa^Efs, Xu, Xu, Xu, Xu
Xu, Xu, Xu, Xu, Xu, Wog, Wwg, Cud, Isa, Xoa, Uh^Tf, Isa^Em, Isa, Xoa, Uh^Tf, Xoa^Efs, Xoa, Qxu, Qxu^Bh/, Uu, Uu^Tf, Xur, Xur, Isa, Uu^Tf, Isa, Isa, Uh, Qxu, Qxu, Wog, Wog, Wwg, Xu, Xu, Xu, Xu, Xu, Isa^Edt, Uu^Tf, Wwg, Wwg, Xu, Xu, Xu, Xu
Xu, Xu, Xu, Xu, Cud, Wwg, Wwg, Cud, Cud, Xoa^Efs, Xoa, Uh, Isa, Uu^Tf, Uu^Em, Uh, Isa, Qxu^Bh/, Qxu, Uh, Isa, Isa, Isa, Uh, Isa, Isa, Uu, Isa, Qxu^Bh\, Qxu, Wwg, Wwg, Uh^Tf, Xoa^Efs, Xoa, Xu, Xoa, Xoa^Efs, Uh^Tf, Isa, Wwg, Wog, Wog, Xu, Xu, Xu
Xu, Xu, Xu, Xu, Cud, Wwg, Wwg, Wog, Wwg, Wog, Wwg, Xoa, Wwg, Isa, Xoa, Isa, Qxu, Qxu, Qxu, Isa, Cud, Uu^Tf, Uh, Isa, Isa^Edt, Uh, Qxu, Qxu, Qxu, Qxu^Bh\, Isa, Isa^Edt, Uu^Tf, Uh, Isa^Edt, Uh, Isa, Uu^Tf, Uu^Em, Isa, Xoa, Wwg, Wwg, Xu, Xu, Xu
Xu, Xu, Xu, Xu, Xu, Cud, Xu, Wwg, Wog, Wwg, Xu, Wwg, Wwg, Wwg, Xu, Xoa, Qxu, Qxu, Isa, Cud, Cud, Uh, Cud, Uu, Isa^Edt, Isa^Edt, Qxu, Qxu, Qxu, Qxu, Xu, Uu^Em, Xoa, Isa, Uu^Em, Uu^Tf, Uh^Tf, Isa^Edt, Xoa, Xoa, Xu, Wwg, Wog, Xu, Xu, Xu
Xu, Xu, Xu, Xu, Xu, Xu, Xu, Xu, Xu, Xu, Xu, Xu, Xu, Xu, Xu, Xu, Qxu, Qxu, Isa, Isa, Isa^Edt, Cud, Cud, Cud, Uu, Uu^Tf, Cud, Qxu, Qxu, Qxu, Qxu, Xu, Xu, Xoa, Wwg, Wwg, Xoa, Xoa, Xu, Xu, Wwg, Wwg, Wog, Xu, Xu, Xu
Xu, Xu, Xu, Xu, Xu, Xu, Xu, Xu, Xu, Xu, Xu, Xu, Xu, Xu, Xu, Qxu, Qxu, Qxu, Qxu, Isa^Edt, Isa^Edt, Uh, Uu, Cud, Isa^Edt, Uh, Uu, Qxu, Qxu, Qxu, Qxu, Xu, Xu, Xu, Wog, Wwg, Wwg, Xu, Wog, Wog, Wwg, Wwg, Xu, Xu, Xu, Xu
Xu, Xu, Xu, Xu, Xu, Xu, Xu, Xu, Xu, Xu, Xu, Xu, Xu, Xu, Xu, Qxu, Qxu, Qxu, Qxu, Uu^Tf, Uu, Isa, Isa^Edt, Uu, Isa, Isa, Isa, Isa, Qxu, Qxu, Qxu, Qxu, Xu, Xu, Xu, Wog, Wwg, Wwg, Wwg, Wwg, Xu, Xu, Xu, Xu, Xu, Xu
Xu, Xu, Xu, Xu, Xu, Xu, Xu, Xu, Xu, Xu, Xu, Xu, Xu, Xu, Xu, Xu, Qxu, Qxu, Qxu, Uh, Xur, Isa^Edt, Isa, Isa, Xur, Uu^Tf, Uh, Isa, Qxu, Qxu, Qxu, Qxu, Xu, Xu, Xu, Xu, Xu, Xu, Xu, Xu, Xu, Xu, Xu, Xu, Xu, Xu
Xu, Xu, Xu, Xu, Xu, Xu, Xu, Xu, Xu, Xu, Xof, Xu, Xu, Xu, Xu, Xu, Qxu, Qxu, Uu^Tf, Isa, Isa^Edt, Xur, Uu^Tf, Isa, Isa^Edt, Xur, Isa, Qxu, Qxu, Qxu, Qxu, Qxu, Xu, Xu, Xu, Xu, Xu, Xu, Xu, Xu, Xof, Xof, Xof, Xu, Xu, Xu
Xu, Xu, Xu, Xu, Xu, Xu, Xu, Xu, Xof, Xof, Ur, Xof, Xof, Xu, Xu, Qxu, Qxu, Qxu, Uh, Uu, Isa, Isa^Edt, Isa^Edt, Uu, Isa^Edt, Isa^Edt, Uu^Tf, Qxu, Qxu, Qxu, Qxu, Qxu, Xu, Xu, Xu, Xu, Xu, Xu, Xu, Xof, Ur, Ur, Ur, Xof, Xu, Xu
Xu, Xu, Xu, Xu, Xu, Xu, Xoa, Xu, Xof^Efs, Ur, Ur^Ebn, Ur, Xof, Xu, Xu, Qxu, Qxu, Qxu, Isa, Isa^Edt, Isa^Edt, Isa, Isa, Isa, Uh, Uu, Isa, Qxu, Qxu, Qxu, Qxu, Xu, Xu, Xu, Xu, Xu, Xu, Xu, Xoa, Xof^Efs, Ur, Ur^Ebn, Ur, Xof, Xu, Xu
Xu, Xu, Xu, Xu, Xoa, Xoa^Efs, Isa, Xoa, Cud, Ur, Ur, Ur, Xof, Xu, Qxu, Qxu, Qxu, Qxu, Qxu, Isa^Edt, Uh, Xur, Xur, Isa, Isa, Uh, Isa, Isa, Qxu, Qxu, Xu, Xu, Xu, Xu, Xu, Xu, Xoa, Xoa^Efs, Uh^Tf, Cud, Kud, Ur, Xof, Xof, Xu, Xu
Xu, Xu, Xu, Xu, Xoa, Uh, Uu^Vud, Uu^Em, Cud, Kud, Cud, Xof, Xu, Xu, Qxu, Qxu, Qxu, Qxu, Qxu, Isa, Isa, Uu^Tf, Isa^Edt, Isa, Isa, Isa, Uu^Tf, Isa, Qxu, Qxu, Xu, Xu, Xu, Xu, Xu, Xu, Xoa, Isa, Uu^Vud, Cud, Cud, Cud, Xoa^Efs, Xu, Xu, Xu
Wog, Xu, Xu, Xu, Xoa, Uh^Tf, Uu^Tf, Isa, Isa, Cud, Xoa, Xoa, Wog, Xu, Xu, Qxu, Qxu, Qxu, Uu^Tf, Uu^Tf, Isa, Isa^Edt, Isa^Edt, Uu, Isa, Isa, Uh, Uu, Qxu, Qxu, Xu, Xu, Xu, Xu, Xu, Xu, Xoa, Isa, Isa, Isa, Isa^Edt, Isa^Edt, Isa, Xoa, Xu, Xu
Xu, Wog, Wog, Xu, Xu, Xoa, Xoa, Isa, Uh, Uu^Vud, Xoa, Wog, Wog, Xu, Xu, Qxu, Qxu, Qxu, Isa, Uh, Isa, Uh, Isa, Uu, Uu^Tf, Isa^Edt, Isa^Edt, Qxu, Qxu, Qxu, Xu, Xu, Xu, Xu, Xu, Xu, Xu, Xoa, Uh, Uu^Em, Isa, Uh^Vud, Uh^Tf, Xoa, Xu, Xu
Xu, Xu, Wog, Xu, Xu, Xu, Xoa^Efs, Uu, Isa, Xoa, Xu, Xu, Wog, Wog, Xu, Qxu, Qxu, Qxu, Qxu^Bh|, Isa, Qxu^Bh|, Uu^Tf, Isa, Isa, Isa, Isa^Edt, Isa, Qxu, Qxu, Qxu, Qxu, Xu, Xu, Xu, Xu, Xu, Cud, Xoa^Efs, Wwf^Edt, Wwf^Edt, Xoa, Uu, Xoa, Xoa, Xu, Xu
Xu, Xu, Wog, Xu, Wog, Xoa, Isa, Isa, Uu^Em, Xoa^Efs, Wwg, Wog, Wog, Wog, Wog, Xu, Qxu, Qxu, Qxu^Bh|, Qxu^Bh|, Qxu^Bh|, Qxu^Bh|, Qxu^Bh|, Qxu^Bh|, Qxu^Bh|, Isa, Qxu^Bh|, Qxu, Qxu, Qxu, Qxu, Xu, Xu, Xu, Xu, Cud, Uu^Em, Uh^Tf, Wwf^Edt, Wwg^Edt, Xoa, Xoa, Xu, Xu, Xu, Xu
Xu, Xu, Xu, Wog, Wwg, Wwg, Uh, Isa, Uu^Tf, Uh^Tf, Isa, Wwg, Wwg, Xu, Wog, Xu, Qxu, Qxu, Qxu^Bh|, Qxu^Bh|, Qxu^Bh|, Qxu^Bh|, Qxu^Bh|, Qxu^Bh|, Qxu^Bh|, Qxu^Bh|, Qxu^Bh|, Qxu, Qxu, Qxu, Qxu, Xu, Xu, Xu, Xoa, Xoa^Efs, Wwg^Edt, Wwg^Edt, Cud, Cud, Xoa, Xu, Xu, Xu, Xu, Xu
Xu, Xu, Xu, Wog, Wwg, Uu^Tf, Uu, Isa, Wwg, Isa, Uh^Tf, Uu^Tf, Isa, Wwg, Wwg, Xu, Qxu, Qxu, Qxu^Bh|, Qxu^Bh|, Isa, Qxu^Bh|, Isa, Qxu^Bh|, Qxu^Bh|, Qxu^Bh|, Qxu^Bh|, Qxu, Qxu, Qxu, Xu, Xu, Xu, Xoa, Cud, Cud, Wwf^Edt, Wwg^Edt, Xoa^Efs, Xoa, Xu, Xu, Xu, Xu, Xu, Xu
Xu, Xu, Xu, Xu, Wwg, Isa, Isa, Wwg, Wog, Wwg, Wwg, Uh, Isa, Wwg, Xu, Xu, Xu, Qxu, Isa, Uu, Uu^Tf, Isa, Uu, Uu^Tf, Isa, Qxu^Bh|, Uu^Tf, Uu^Tf, Isa, Xu, Xu, Xu, Xu, Xoa, Wwg^Edt, Wwg^Edt, Uh, Uu^Tf, Cud, Xu, Xu, Xu, Xu, Xu, Xu, Xu
Xu, Xu, Xu, Wog, Wwg, Uh^Tf, Isa, Wwg, Wog, Wog, Wwg, Isa, Uu^Tf, Wwg, Xoa^Efs, Xu, Xu, Uu^Tf, Uh, Isa, Isa, Isa, Xu, Isa, Isa, Uu, Uh, Isa, Uu^Tf, Xu, Xu, Xu, Xoa, Wwf^Edt, Wwf^Edt, Wwg^Edt, Xoa, Cud, Xu, Xu, Xu, Xu, Xu, Xu, Xu, Xu
Xu, Xu, Wog, Wog, Wwg, Uu^Tf, Uu^Em, Wwg, Wwg, Wwg, Isa, Uu, Isa, Isa, Uh, Xoa, Isa, Uu, Isa^Ecf, Isa, Uu, Xu, Xu, Xu, Uu^Tf, Isa, Isa, Isa, Uh, Isa, Xu, Xu, Xoa, Uh^Tf, Isa, Xoa, Xu, Xu, Xu, Xu, Xu, Xu, Xu, Xu, Xu, Xu
Xu, Xu, Wog, Xu, Wwg, Isa, Isa, Isa, Uh^Tf, Uu^Tf, Isa, Uh, Xoa, Uu, Isa, Isa, Isa, Isa, Isa, Isa, Uh, Xu, Xu, Xu, Xu, Uh, Isa, Uu, Isa, Isa^Ecf, Uu^Tf, Xoa, Uu, Uh, Uu^Tf, Xoa, Xu, Xu, Xu, Xu, Xu, Xu, Xu, Xu, Xu, Xu
Xu, Xu, Wog, Xu, Xu, Wwg, Wwg, Isa, Uu^Em, Uh, Wwg, Xoa, Xu, Xu, Xu, Isa^Ecf, Uh, Uu^Tf, Ce, Ce^Vct, Ce^Vct, Uh, Xu, Xu, Xu, Uu^Tf, Ce^Vct, Ce^Vct, Ce, Uu, Uh, Isa, Isa, Isa, Xoa, Xoa, Xu, Xu, Xu, Xu, Xu, Xu, Xu, Xu, Xu, Xu
Xu, Xu, Xu, Wog, Wog, Wog, Wog, Wwg, Wwg, Wwg, Wog, Wog, Xu, Xu, Xu, Uu, Ce^Vct, Ce, 1 Ke, Ce^Vct, Ce^Vct, Isa, Isa, Xu, Uu^Tf, Isa, Ce^Vct, Ce^Vct, 2 Ke, Ce, Ce^Vct, Uu, Isa^Ecf, Isa, Xu, Xu, Xu, Xu, Xu, Xu, Xu, Xu, Xu, Xu, Xu, Xu
Xu, Xu, Xu, Wog, Xu, Xu, Xu, Wog, Xu, Xu, Xu, Wog, Xu, Xu, Xu, Uu^Tf, Ce^Vct, Ce^Vct, Ce, Ce, Isa, Uu, Uu, Uu^Tf, Uh, Isa, Uh, Ce, Ce, Ce^Vct, Ce^Vct, Isa, Uh, Uu^Tf, Xu, Xu, Xu, Xu, Xu, Xu, Xu, Xu, Xu, Xu, Xu, Xu
Xu, Xu, Wog, Wog, Xu, Xu, Xu, Xu, Xu, Xu, Wog, Wog, Xu, Xu, Uu^Tf, Isa, Isa, Ce^Vct, Uh, Uu^Tf, Isa, Isa^Ecf, Uu, Uh, Isa, Isa^Ecf, Uu, Uu^Tf, Isa, Ce^Vct, Uu^Tf, Isa, Uu, Xu, Xu, Xu, Xu, Xu, Xu, Xu, Xu, Xu, Xu, Xu, Xu, Xu
Xu, Xu, Wog, Xu, Xu, Xu, Xu, Xu, Xu, Xu, Wog, Xu, Xu, Xu, Uu, Uu, Isa, Isa, Uu, Uu, Isa, Isa, Isa, Uu, Isa, Uu, Uu, Isa, Isa, Isa, Uu, Uu, Xu, Xu, Xu, Xu, Xu, Xu, Xu, Xu, Xu, Xu, Xu, Xu, Xu, Xu
