Qxu, Qxu, Qxu, Qxu, Qxu, Qxu, Qxu, Qxu, Qxu, Qxu, Qxu, Qxu, Qxu, Qxu, Qxu, Qxu, Qxu, Qxu, Qxu, Qxu, Xoa, Qxu, Xoa, Xoa, Xoa, Qxu, Xoa, Qxu, Qxu, Qxu, Qxu, Qxu, Qxu, Qxu, Qxu, Qxu, Qxu, Qxu, Qxu, Qxu, Qxu, Qxu, Qxu, Qxu, Qxu, Qxu
Qxu, Qxu, Qxu, Qxu, Qxu, Qxu, Qxu, Qxu, Qxu, Qxu, Qxu, Qxu, Qxu, Qxu, Qxu, Qxu, Qxu, Qxu, Xoa, Xoa, Cud^Ebn, Qxu, Qxu, Xoa, Qxu, Qxu, Cud^Ebn, Xoa, Xoa, Qxu, Qxu, Qxu, Qxu, Qxu, Qxu, Qxu, Qxu, Qxu, Qxu, Qxu, Qxu, Qxu, Qxu, Qxu, Qxu, Qxu
Qxu, Qxu, Qxu, Qxu, Qxu, Qxu, Qxu, Qxu, Qxu, Qxu, Qxu, Qxu, Qxu, Qxu, Qxu, Qxu, Qxu, Xoa, Cud, Cud, Qxu, Qxu, Qxu, Qxu, Qxu, Qxu, Qxu, Cud, Cud, Xoa, Qxu, Qxu, Qxu, Qxu, Qxu, Qxu, Qxu, Qxu, Qxu, Qxu, Qxu, Qxu, Qxu, Qxu, Qxu, Qxu
Qxu, Qxu, Qxu, Qxu, Qxu, Qxu, Qxu, Qxu, Qxu, Qxu, Qxu, Qxu, Qxu, Qxu, Qxu, Qxu, Qxu, Xoa, Cud, Qxu, Qxu, Qxu, Xoa, Xoa, Xoa, Qxu, Qxu, Qxu, Cud, Xoa, Qxu, Qxu, Qxu, Qxu, Qxu, Qxu, Qxu, Qxu, Qxu, Qxu, Qxu, Qxu, Qxu, Qxu, Qxu, Qxu
Qxu, Qxu, Qxu, Qxu, Qxu, Qxu, Qxu, Qxu, Qxu, Qxu, Qxu, Qxu, Qxu, Qxu, Qxu, Qxu, Qxu, Xoa, Cud^Ebn, Qxu, Qxu, Xoa, Xoa, Xoa, Xoa, Xoa, Qxu, Qxu, Cud^Ebn, Xoa, Qxu, Qxu, Qxu, Qxu, Qxu, Qxu, Qxu, Qxu, Qxu, Qxu, Qxu, Qxu, Qxu, Qxu, Qxu, Qxu
Qxu, Qxu, Qxu, Qxu, Qxu, Qxu, Qxu, Qxu, Qxu, Qxu, Qxu, Qxu, Qxu, Qxu, Qxu, Qxu, Qxu, Xoa, Qxu, Qxu, Qxu, Xoa, Xoa, Xoa, Xoa, Xoa, Qxu, Qxu, Qxu, Xoa, Qxu, Qxu, Qxu, Qxu, Qxu, Qxu, Qxu, Qxu, Qxu, Qxu, Qxu, Qxu, Qxu, Qxu, Qxu, Qxu
Qxu, Qxu, Qxu, Qxu, Qxu, Qxu, Qxu, Qxu, Qxu, Qxu, Qxu, Qxu, Qxu, Qxu, Qxu, Qxu, Qxu, Qxu, Qxu, Qxu, Qxu, Xoa, Xoa, Xoa, Xoa, Xoa, Qxu, Qxu, Qxu, Qxu, Qxu, Qxu, Qxu, Qxu, Qxu, Qxu, Qxu, Qxu, Qxu, Qxu, Qxu, Qxu, Qxu, Qxu, Qxu, Qxu
Qxu, Qxu, Qxu, Qxu, Qxu, Qxu, Qxu, Qxu, Qxu, Qxu, Qxu, Qxu, Qxu, Qxu, Qxu, Qxu, Xoa, Xoa, Xoa, Qxu, Qxu, Qxu, Qxu, Xoa, Qxu, Qxu, Qxu, Qxu, Xoa, Xoa, Xoa, Qxu, Qxu, Qxu, Qxu, Qxu, Qxu, Qxu, Qxu, Qxu, Qxu, Qxu, Qxu, Qxu, Qxu, Qxu
Qxu, Qxu, Qxu, Qxu, Qxu, Qxu, Qxu, Qxu, Qxu, Qxu, Qxu, Qxu, Qxu, Qxu, Qxu, Qxu, Xoa, Xoa, Xoa, Qxu, Qxu, Qxu, Qxu, Qxu, Qxu, Qxu, Qxu, Qxu, Xoa, Xoa, Xoa, Qxu, Qxu, Qxu, Qxu, Qxu, Qxu, Qxu, Qxu, Qxu, Qxu, Qxu, Qxu, Qxu, Qxu, Qxu
Qxu, Qxu, Qxu, Qxu, Qxu, Qxu, Qxu, Qxu, Qxu, Qxu, Qxu, Qxu, Qxu, Qxu, Qxu, Qxu, Qxu, Xoa, Qxu, Qxu, Xoa, Cud^Ebn, Cud, Qxu, Cud, Cud^Ebn, Xoa, Qxu, Qxu, Xoa, Qxu, Qxu, Qxu, Qxu, Qxu, Qxu, Qxu, Qxu, Qxu, Qxu, Qxu, Qxu, Qxu, Qxu, Qxu, Qxu
Qxu, Qxu, Qxu, Qxu, Qxu, Qxu, Qxu, Qxu, Qxu, Qxu, Isa, Qxu, Qxu, Qxu, Qxu, Qxu, Qxu, Qxu, Qxu, Qxu, Qxu, Xoa, Xoa, Cud, Xoa, Xoa, Qxu, Qxu, Qxu, Qxu, Qxu, Qxu, Qxu, Qxu, Qxu, Qxu, Qxu, Qxu, Qxu, Qxu, Qxu, Qxu, Qxu, Qxu, Qxu, Qxu
Qxu, Qxu, Qxu, Qxu, Qxu, Qxu, Xu, Xu, Xu, Isa, Isa, Isa, Isa, Qxu, Isa, Isa, Isa, Qxu, Qxu, Qxu, Qxu, Qxu, Qxu, Xoa, Qxu, Qxu, Qxu, Qxu, Qxu, Qxu, Qxu, Qxu, Qxu, Qxu, Isa, Qxu, Qxu, Qxu, Isa, Qxu, Qxu, Qxu, Qxu, Qxu, Qxu, Qxu
Qxu, Qxu, Qxu, Qxu, Qxu, Xu, Xu, Xu, Xu, Isa, Isa, Isa, Isa, Isa, Isa, Isa, Isa, Qxu, Qxu, Qxu, Qxu, Qxu, Qxu, Qxu, Qxu, Qxu, Isa, Qxu, Qxu, Qxu, Isa, Qxu, Isa, Isa, Isa, Isa, Isa, Isa, Isa, Isa, Isa, Qxu, Qxu, Qxu, Qxu, Qxu
Qxu, Qxu, Qxu, Qxu, Xu, Xu, Xu, Xu, Xu, Isa, Isa, Isa, Isa, Isa, Isa, Isa, Isa, Isa, Isa, Qxu, Isa, Qxu, Qxu, Qxu, Isa, Isa, Isa, Isa, Isa, Isa, Isa, Isa, Isa, Isa, Isa, Isa, Isa, Isa, Isa, Isa, Isa, Qxu, Qxu, Qxu, Qxu, Qxu
Qxu, Qxu, Qxu, Qxu, Xu, Xu, Xu, Xu, Isa, Isa, Isa, Isa, Isa, Isa, Isa, Isa, Isa, Isa, Isa, Isa, Isa, Isa, Isa, Isa, Isa, Isa, Isa, Isa, Isa, Isa, Isa, Isa, Isa, Isa, Isa, Isa, Isa, Isa, Isa, Isa, Isa, Isa, Xu, Xu, Xu, Qxu
Qxu, Qxu, Qxu, Xu, Xu, Xu, Xu, Isa, Isa, Isa, Cud, Cud, Cud, Isa, Isa, Isa, Isa, Isa, Isa, Isa, Isa, Isa, Isa, Isa, Isa, Isa, Isa, Isa, Isa, Isa, Isa, Isa, Isa, Isa, Isa, Isa, Cud, Cud, Cud, Isa, Isa, Isa, Xu, Xu, Xu, Xu
Qxu, Qxu, Qxu, Xu, Xu, Xu, Xu, Isa, Isa, Isa, Cud, Kud, Cud, Isa, Isa, Isa, Isa, Isa, Cud, Cud, Cud, Isa, Isa, Isa, Isa, Isa, Cud, Cud, Cud, Isa, Isa, Isa, Isa, Isa, Isa, Isa, Cud, Kud, Cud, Isa, Isa, Isa, Xu, Xu, Xu, Xu
Qxu, Qxu, Xu, Xu, Xu, Xu, Xu, Isa, Isa, Isa, Isa, Cud, Isa, Isa, Isa, Isa, Isa, Isa, Cud, Kud, Cud, Isa, Isa, Isa, Isa, Isa, Cud, Kud, Cud, Isa, Isa, Isa, Isa, Isa, Isa, Isa, Isa, Cud, Isa, Isa, Isa, Xu, Xu, Xu, Xu, Xu
Qxu, Qxu, Xu, Xu, Xu, Xu, Xu, Isa, Isa, Isa, Isa, Isa, Isa, Isa, Isa, Isa, Isa, Isa, Isa, Cud, Isa, Isa, Isa, Isa, Isa, Isa, Isa, Cud, Isa, Isa, Isa, Isa, Isa, Isa, Isa, Isa, Isa, Isa, Isa, Isa, Xu, Xu, Xu, Xu, Xu, Xu
Qxu, Xu, Xu, Xu, Xu, Xu, Xu, Xu, Xu, Isa, Isa, Isa, Isa, Isa, Isa, Isa, Isa, Isa, Isa, Isa, Isa, Isa, Cud, Isa, Cud, Isa, Cud, Isa, Isa, Isa, Isa, Isa, Isa, Isa, Isa, Isa, Isa, Isa, Isa, Isa, Xu, Xu, Xu, Xu, Xu, Xu
Xu, Xu, Xu, Xu, Xu, Xu, Xu, Xu, Xu, Xu, Xu, Isa, Xu, Xu, Xu, Isa, Xu, Isa, Cud, Cud, Cud, Cud, Cud, Cud, Qxu^Bh|, Cud, Cud, Cud, Cud, Isa, Xu, Isa, Isa, Isa, Isa, Isa, Xu, Isa, Xu, Xu, Xu, Xu, Isa, Xu, Xu, Xu
Xu, Xu, Xu, Xu, Isa, Isa, Isa, Xu, Xu, Xu, Xu, Xu, Xu, Xu, Xu, Xu, Xu, Xu, Qxu, Cud, Qxu^Bh|, Qxu^Bh|, Qxu^Bh|, Qxu^Bh|, Qxu^Bh|, Qxu^Bh|, Qxu^Bh|, Qxu, Qxu, Xu, Xu, Xu, Xu, Isa, Xu, Xu, Xu, Xu, Xu, Xu, Xu, Isa, Isa, Isa, Xu, Xu
Xu, Xu, Xu, Xu, Isa, Isa, Isa, Xu, Xu, Xu, Xu, Xu, Xu, Xu, Xu, Xu, Xu, Qxu, Qxu, Qxu^Bh|, Qxu^Bh|, Qxu^Bh|, Qxu^Bh|, Qxu^Bh|, Qxu^Bh|, Qxu^Bh|, Qxu^Bh|, Qxu, Qxu, Qxu, Xu, Xu, Xu, Xu, Xu, Xu, Xu, Xu, Isa, Xu, Cud, Isa, Isa, Isa, Xu, Xu
Xu, Xu, Xu, Xu, Xu, Isa, Kud, Cud, Isa, Isa, Isa, Cud, Wog, Xu, Xu, Xu, Qxu, Qxu, Qxu, Qxu^Bh|, Uu, Qxu^Bh|, Uu, Qxu^Bh|, Uu, Uu, Uu, Qxu, Qxu, Qxu, Xu, Xu, Xu, Xu, Cud, Xu, Isa, Isa, Isa, Isa, Cud, Kud, Cud, Xu, Xu, Xu
Xu, Xu, Xu, Xu, Xu, Cud, Cud, Cud, Isa, Isa, Isa, Wwg, Wwg, Wog, Xu, Xu, Qxu, Qxu, Uu, Uu, Uu, Uu, Uu, Uu, Uu, Cud, Cud, Qxu, Qxu, Qxu, Wog, Xu, Wog, Cud, Wwg, Cud, Cud, Isa, Isa, Isa, Isa, Cud, Isa, Xu, Xu, Xu
Xu, Xu, Xu, Xu, Isa, Isa, Isa, Isa, Isa, Isa, Xu, Cud, Cud, Wog, Wwg, Cud, Qxu, Qxu, Uu, Uu, Uu, Uu, Uu, Cud, Cud, Cud, Qxu, Qxu, Qxu, Qxu, Qxu, Wog, Wog, Wwg, Wwg, Wwg, Cud, Isa, Isa, Isa, Isa, Isa, Isa, Xu, Xu, Xu
Xu, Xu, Xu, Xu, Isa, Isa, Isa, Isa, Isa, Isa, Isa, Xu, Cud, Wwg, Wwg, Cud, Qxu, Qxu, Qxu, Uu, Uu, Cud, Cud, Cud, Uu, Uu, Qxu, Qxu, Qxu, Qxu, Xu, Wog, Wwg, Wwg, Xu, Wwg, Cud, Cud, Xu, Isa, Isa, Isa, Xu, Xu, Xu, Xu
Xu, Xu, Xu, Xu, Cud, Isa, Cud, Xu, Xu, Isa, Isa, Xu, Xu, Wog, Wwg, Wog, Qxu, Qxu, Qxu, Qxu, Uu, Cud, Uu, Uu, Uu, Uu, Uu, Qxu, Qxu, Qxu, Xu, Cud, Wwg, Cud, Xu, Xu, Xu, Xu, Xu, Isa, Isa, Xu, Xu, Xu, Xu, Xu
Xu, Xu, Xu, Xu, Xu, Wog, Wwg, Xu, Xu, Isa, Isa, Isa, Xu, Cud, Wwg, Xu, Xu, Qxu, Qxu, Qxu, Uu, Uu, Uu, Uu, Uu, Uu, Uu, Uu, Qxu, Qxu, Qxu, Xu, Wwg, Xu, Xu, Xu, Xu, Xu, Isa, Isa, Isa, Xu, Xu, Xu, Xu, Xu
Xu, Xu, Xu, Xu, Xu, Wog, Wwg, Cud, Isa, Xu, Isa, Isa, Isa, Xu, Isa, Xu, Xu, Qxu, Qxu, Uu, Uu, Uu, Uu, Uu, Uu, Uu, Uu, Uu, Qxu, Qxu, Wwg, Wwg, Xu, Xu, Xu, Xu, Xu, Xu, Isa, Isa, Wwg, Wwg, Xu, Xu, Xu, Xu
Xu, Xu, Xu, Xu, Cud, Wwg, Wwg, Cud, Cud, Xu, Xu, Isa, Isa, Isa, Isa, Isa, Qxu, Qxu, Qxu, Uu, Uu, Uu, Uu, Uu, Uu, Uu, Uu, Uu, Qxu, Qxu, Isa, Xu, Isa, Xu, Xu, Xu, Xu, Xu, Isa, Isa, Wwg, Wog, Wog, Xu, Xu, Xu
Xu, Xu, Xu, Xu, Cud, Wwg, Wwg, Wog, Wwg, Wog, Wwg, Xu, Wwg, Isa, Xu, Isa, Qxu, Qxu, Cud, Cud, Uu, Uu, Uu, Uu, Uu, Uu, Qxu, Qxu, Qxu, Qxu, Isa, Isa, Isa, Isa, Isa, Isa, Isa, Isa, Isa, Isa, Xu, Wwg, Wwg, Xu, Xu, Xu
Xu, Xu, Xu, Xu, Xu, Cud, Xu, Wwg, Wog, Wwg, Xu, Wwg, Wwg, Wwg, Xu, Xu, Qxu, Qxu, Uu, Cud, Cud, Cud, Uu, Uu, Uu, Uu, Qxu, Qxu, Qxu, Qxu, Xu, Isa, Xu, Isa, Isa, Isa, Isa, Isa, Xu, Xu, Xu, Wwg, Wog, Xu, Xu, Xu
Xu, Xu, Xu, Xu, Xu, Xu, Xu, Xu, Xu, Xu, Xu, Xu, Xu, Xu, Xu, Xu, Qxu, Qxu, Uu, Uu, Uu, Cud, Cud, Cud, Uu, Uu, Cud, Qxu, Qxu, Qxu, Qxu, Xu, Xu, Xu, Wwg, Wwg, Xu, Xu, Xu, Xu, Wwg, Wwg, Wog, Xu, Xu, Xu
Xu, Xu, Xu, Xu, Xu, Xu, Xu, Xu, Xu, Xu, Xu, Xu, Xu, Xu, Xu, Qxu, Qxu, Qxu, Qxu, Uu, Uu, Uu, Uu, Cud, Uu, Uu, Uu, Qxu, Qxu, Qxu, Qxu, Xu, Xu, Xu, Wog, Wwg, Wwg, Xu, Wog, Wog, Wwg, Wwg, Xu, Xu, Xu, Xu
Xu, Xu, Xu, Xu, Xu, Xu, Xu, Xu, Xu, Xu, Xu, Xu, Xu, Xu, Xu, Qxu, Qxu, Qxu, Qxu, Uu, Uu, Uu, Uu, Uu, Uu, Uu, Uu, Uu, Qxu, Qxu, Qxu, Qxu, Xu, Xu, Xu, Wog, Wwg, Wwg, Wwg, Wwg, Xu, Xu, Xu, Xu, Xu, Xu
Xu, Xu, Xu, Xu, Xu, Xu, Xu, Xu, Xu, Xu, Xu, Xu, Xu, Xu, Xu, Xu, Qxu, Qxu, Qxu, Uu, Uu, Uu, Uu, Uu, Uu, Uu, Uu, Uu, Qxu, Qxu, Qxu, Qxu, Xu, Xu, Xu, Xu, Xu, Xu, Xu, Xu, Xu, Xu, Xu, Xu, Xu, Xu
Xu, Xu, Xu, Xu, Xu, Xu, Xu, Xu, Xu, Xu, Xu, Xu, Xu, Xu, Xu, Xu, Qxu, Qxu, Uu, Uu, Uu, Uu, Uu, Uu, Uu, Uu, Uu, Qxu, Qxu, Qxu, Qxu, Qxu, Xu, Xu, Xu, Xu, Xu, Xu, Xu, Xu, Xu, Xu, Xu, Xu, Xu, Xu
Xu, Xu, Xu, Xu, Xu, Xu, Xu, Xu, Xu, Xu, Isa, Xu, Xu, Xu, Xu, Qxu, Qxu, Qxu, Uu, Uu, Uu, Uu, Uu, Uu, Uu, Uu, Uu, Qxu, Qxu, Qxu, Qxu, Qxu, Xu, Xu, Xu, Xu, Xu, Xu, Xu, Xu, Isa, Isa, Isa, Xu, Xu, Xu
Xu, Xu, Xu, Xu, Xu, Xu, Xu, Xu, Xu, Isa, Isa, Isa, Xu, Xu, Xu, Qxu, Qxu, Qxu, Uu, Uu, Uu, Uu, Uu, Uu, Uu, Uu, Uu, Qxu, Qxu, Qxu, Qxu, Xu, Xu, Xu, Xu, Xu, Xu, Xu, Xu, Xu, Isa, Isa, Isa, Xu, Xu, Xu
Xu, Xu, Xu, Xu, Xu, Xu, Isa, Xu, Cud, Isa, Isa, Isa, Xu, Xu, Qxu, Qxu, Qxu, Qxu, Qxu, Uu, Uu, Uu, Uu, Uu, Uu, Uu, Uu, Uu, Qxu, Qxu, Xu, Xu, Xu, Xu, Xu, Xu, Xu, Xu, Isa, Cud, Kud, Isa, Xu, Xu, Xu, Xu
Xu, Xu, Xu, Xu, Xu, Isa, Isa, Isa, Cud, Kud, Cud, Xu, Xu, Xu, Qxu, Qxu, Qxu, Qxu, Qxu, Uu, Uu, Uu, Uu, Uu, Uu, Uu, Uu, Uu, Qxu, Qxu, Xu, Xu, Xu, Xu, Xu, Xu, Xu, Isa, Isa, Cud, Cud, Cud, Xu, Xu, Xu, Xu
Xu, Xu, Xu, Xu, Xu, Isa, Isa, Isa, Isa, Cud, Xu, Xu, Xu, Xu, Xu, Qxu, Qxu, Qxu, Uu, Uu, Uu, Uu, Uu, Uu, Uu, Uu, Uu, Uu, Qxu, Qxu, Xu, Xu, Xu, Xu, Xu, Xu, Xu, Isa, Isa, Isa, Isa, Isa, Isa, Xu, Xu, Xu
Xu, Xu, Xu, Xu, Xu, Xu, Xu, Isa, Isa, Isa, Xu, Xu, Xu, Xu, Xu, Qxu, Qxu, Qxu, Uu, Uu, Uu, Uu, Uu, Uu, Uu, Uu, Uu, Qxu, Qxu, Qxu, Xu, Xu, Xu, Xu, Xu, Xu, Xu, Xu, Isa, Isa, Isa, Isa, Isa, Xu, Xu, Xu
Xu, Xu, Xu, Xu, Xu, Xu, Xu, Isa, Isa, Xu, Xu, Xu, Xu, Xu, Xu, Qxu, Qxu, Qxu, Qxu^Bh|, Uu, Qxu^Bh|, Uu, Uu, Uu, Uu, Uu, Uu, Qxu, Qxu, Qxu, Qxu, Xu, Xu, Xu, Xu, Xu, Cud, Xu, Wwf, Wwf, Xu, Isa, Xu, Xu, Xu, Xu
Xu, Xu, Xu, Xu, Xu, Xu, Isa, Isa, Isa, Xu, Xu, Xu, Xu, Xu, Xu, Xu, Qxu, Qxu, Qxu^Bh|, Qxu^Bh|, Qxu^Bh|, Qxu^Bh|, Qxu^Bh|, Qxu^Bh|, Qxu^Bh|, Uu, Qxu^Bh|, Qxu, Qxu, Qxu, Qxu, Xu, Xu, Xu, Xu, Cud, Isa, Isa, Wwf, Wwg, Xu, Xu, Xu, Xu, Xu, Xu
Xu, Xu, Xu, Xu, Xu, Xu, Isa, Isa, Isa, Isa, Isa, Xu, Xu, Xu, Xu, Xu, Qxu, Qxu, Qxu^Bh|, Qxu^Bh|, Qxu^Bh|, Qxu^Bh|, Qxu^Bh|, Qxu^Bh|, Qxu^Bh|, Qxu^Bh|, Qxu^Bh|, Qxu, Qxu, Qxu, Qxu, Xu, Xu, Xu, Xu, Xu, Wwg, Wwg, Cud, Cud, Xu, Xu, Xu, Xu, Xu, Xu
Xu, Xu, Xu, Xu, Xu, Isa, Isa, Isa, Xu, Isa, Isa, Isa, Isa, Xu, Xu, Xu, Qxu, Qxu, Qxu^Bh|, Qxu^Bh|, Uu, Qxu^Bh|, Uu, Qxu^Bh|, Qxu^Bh|, Qxu^Bh|, Qxu^Bh|, Qxu, Qxu, Qxu, Xu, Xu, Xu, Xu, Cud, Cud, Wwf, Wwg, Xu, Xu, Xu, Xu, Xu, Xu, Xu, Xu
Xu, Xu, Xu, Xu, Xu, Isa, Isa, Xu, Xu, Xu, Xu, Isa, Isa, Xu, Xu, Xu, Xu, Qxu, Uu, Uu, Uu, Uu, Uu, Uu, Uu, Qxu^Bh|, Uu, Uu, Uu, Xu, Xu, Xu, Xu, Xu, Wwg, Wwg, Isa, Isa, Cud, Xu, Xu, Xu, Xu, Xu, Xu, Xu
Xu, Xu, Xu, Xu, Xu, Isa, Isa, Xu, Xu, Xu, Xu, Isa, Isa, Xu, Xu, Xu, Xu, Uu, Uu, Uu, Uu, Uu, Xu, Uu, Uu, Uu, Uu, Uu, Uu, Xu, Xu, Xu, Xu, Wwf, Wwf, Wwg, Xu, Cud, Xu, Xu, Xu, Xu, Xu, Xu, Xu, Xu
Xu, Xu, Xu, Xu, Xu, Isa, Isa, Xu, Xu, Xu, Isa, Isa, Isa, Isa, Isa, Xu, Uu, Uu, Uu, Uu, Uu, Xu, Xu, Xu, Uu, Uu, Uu, Uu, Uu, Uu, Xu, Xu, Xu, Isa, Isa, Xu, Xu, Xu, Xu, Xu, Xu, Xu, Xu, Xu, Xu, Xu
Xu, Xu, Xu, Xu, Xu, Isa, Isa, Isa, Isa, Isa, Isa, Isa, Xu, Isa, Isa, Isa, Uu, Uu, Uu, Uu, Uu, Xu, Xu, Xu, Xu, Uu, Uu, Uu, Uu, Uu, Uu, Xu, Isa, Isa, Isa, Xu, Xu, Xu, Xu, Xu, Xu, Xu, Xu, Xu, Xu, Xu
Xu, Xu, Xu, Xu, Xu, Xu, Xu, Isa, Isa, Isa, Xu, Xu, Xu, Xu, Xu, Uu, Uu, Uu, Ce, Ce^Vct, Ce^Vct, Uu, Xu, Xu, Xu, Uu, Ce^Vct, Ce^Vct, Ce, Uu, Uu, Uu, Uu, Isa, Xu, Xu, Xu, Xu, Xu, Xu, Xu, Xu, Xu, Xu, Xu, Xu
Xu, Xu, Xu, Xu, Xu, Xu, Xu, Xu, Xu, Xu, Xu, Xu, Xu, Xu, Xu, Uu, Ce^Vct, Ce, 1 Ke, Ce^Vct, Ce^Vct, Uu, Uu, Xu, Uu, Uu, Ce^Vct, Ce^Vct, 2 Ke, Ce, Ce^Vct, Uu, Uu, Uu, Xu, Xu, Xu, Xu, Xu, Xu, Xu, Xu, Xu, Xu, Xu, Xu
Xu, Xu, Xu, Xu, Xu, Xu, Xu, Xu, Xu, Xu, Xu, Xu, Xu, Xu, Xu, Uu, Ce^Vct, Ce^Vct, Ce, Ce, Uu, Uu, Uu, Uu, Uu, Uu, Uu, Ce, Ce, Ce^Vct, Ce^Vct, Uu, Uu, Uu, Xu, Xu, Xu, Xu, Xu, Xu, Xu, Xu, Xu, Xu, Xu, Xu
Xu, Xu, Xu, Xu, Xu, Xu, Xu, Xu, Xu, Xu, Xu, Xu, Xu, Xu, Uu, Uu, Uu, Ce^Vct, Uu, Uu, Uu, Uu, Uu, Uu, Uu, Uu, Uu, Uu, Uu, Ce^Vct, Uu, Uu, Uu, Xu, Xu, Xu, Xu, Xu, Xu, Xu, Xu, Xu, Xu, Xu, Xu, Xu
Xu, Xu, Xu, Xu, Xu, Xu, Xu, Xu, Xu, Xu, Xu, Xu, Xu, Xu, Uu, Uu, Uu, Uu, Uu, Uu, Uu, Uu, Uu, Uu, Uu, Uu, Uu, Uu, Uu, Uu, Uu, Uu, Xu, Xu, Xu, Xu, Xu, Xu, Xu, Xu, Xu, Xu, Xu, Xu, Xu, Xu
