Gd, Rp, Aa^Fma, Ha^Fda, Ha^Fma, Ha, Ha, Ms^Xm, Ms^Xm, Ms^Xm, Ms^Xm, Ms^Xm, Ms^Xm, Ms^Xm, Ms^Xm, Mm, Ms^Xm, Ms^Xm, Ms^Xm, Ms, Ms^Xm, Ms^Xm, Ms^Xm, Ms^Xm, Ms^Xm, Ms^Xm, Ha, Wo^Qhux, Wo^Qhux, Wo, Ms^Xm, Ms^Xm, Ms^Xm, Ww^Qhu, Ww^Qhu, Wo^Qhu, Wo^Qhu, Wo^Qhu, Ww^Qhu, Wo^Qhu
Gd, Rp, Rp, Ha, Aa^Fma, Ha^Fma, Ha, Ms^Xm, Ms, Ms^Xm, Ms^Xm, Ms^Xm, Ms, Ms, Ms, Ms^Xm, Ms, Ms^Xm, Ms, Ms^Xm, Ms^Xm, Ms^Xm, Ha, Ha, Ha, Ha, Ww^Qhux, Wo^Qhux, Wo^Qhux, Ha, Ms^Xm, Ms^Xm, Ms^Xm, Ha^Qhu, Ha^Qhu, Ww, Wo, Wo, Ww, Ww^Qhu
Aa, Gd, Rp, Aa, Aa^Esa, Aa^Fma, Ha, Ha, Ms, Ms, Ha, Ms, Ha^Fda, Ha, Ha^Fda, Ha^Esa, Ms, Ms, Ms, Ms, Ms, Ms, Wwf^Qhu, Ww^Qhu, Wwg^Qhu, Wwg^Qhu, Ww^Qhux, Wo^Qhux, Ha, Ha, Ms^Xm, Ms^Xm, Ms^Xm, Ms, Ha^Qhu, Ww, Ww^_ml, Wo, Ww, Ww^Qhu
Aa^Esa, Aa, Rp, Aa, Aa, Aa^Esa, Gd, Gd, Aa^Qhh, Ha^Qhh, Ha^Qhh, Ha, Ha^Qhhf, Ha^Fda, Ha^Fda, Ha, Ms, Ms, Ha, Ha^Esa, Ha^Esa, Ha, Wo^Qhu, Wo, Ww^Qhu, Ha, Ha, Ha, Ms^Xm, Ms, Ms, Ms^Xm, Ms^Xm, Ms^Xm, Ms, Ha^Qhu, Ha^Qhu, Ww, Ha^Qhu, Ha^Qhu
Aa^Fma, Aa^Esa, Gd, Rp, Rp, Gd, Gd^Efm, Aa^Qhh, Aa^Vla, Aa^Esa, Aa^Wm, Ha^Qhh, Ha, Ha^Qhh, Ha^Esa, Ms, Ms, Ds^Esd, Ha^Dr, Ds, Ds^Esd, Ww^Qhu, Ww, Ww, Ha^Qhu, Ha^Qhu, Ha, Ms, Ms, Ms, Ms, Ms, Ha^Esa, Ms, Ms, Ha, Ms, Ha^Qhu, Ms^Xm, Ms
Aa^Fma, Aa^Fma, Aa^Fma, Gd, Gd, Rp, Aa^Qhh, Aa^Qhh, Re^Gvs, Re^Gvs, Re^Gvs, Ha, Gd, Aa^Qhh, Ha^Qhh, Ha^Esa, Ha, Ds^Es, Ds^Es, Ds^Esd, Aa^Esa, Ww^Qhu, Wwg^Ewf, Ww^_ml, Ss^Qhu, Ha^Esa, Aa^Esa, Ha, Aa, Ha, Ms, Ms, Ha, Ha^Esa, Ms, Ms^Xm, Ww^Qhu, Ms^Xm, Ha, Ms
Aa^Fma, Aa^Fma, Aa^Fma, Aa, Aa^Qhh, Rp^Qhh, Gd^Eff, Re^Gvs, Re^Gvs, Re^Gvs, Gd^Eff, Gd^Eff, Gd^Em, Aa^Esa, Aa^Esa, Aa^Qhh, Ha, Ha^Esa, Ha^Esa, Ds, Aa, Ww^Qhu, Ww^Qhu, Ww^Qhu, Aa, Aa^Esa, Gd, Gd, Aa^Esa, Aa, Ha^Qhu, Ha^Qhu, Aa^Qhu, Aa^Qhu, Ha^Qhu, Ms, Ha, Ww^Qhu, Ha, Ms
Aa^Fma, Aa^Fma, Aa^Qhh, Aa^Qhh, Aa^Esa, Rp, Rra, Gd^Eff, Aa^Eff, Aa^Eff, Aa^Esa, Gd, Gd, Ha, Ha^Es, Aa^Qhh, Aa, Ha, Ds, Ds^Es, Ha^Esa, Ha^Esa, Ha, Ha, Ha, Ha, Aa^Fma, Aa, Aa, Aa^Esa, Ha^Qhu, Ha, Gd, Gd, Aa^_ml, Ha^Qhu, Ww^Qhu, Ww^Qhu, Ha, Ha
Aa^Esa, Aa^Fma, Aa^Qhh, Aa^Vla, Aa, Aa^Esa, Cva, Rra, Rra, Aa, Aa, Aa^Esa, Gd^Esa, Gd, Gd, Aa^Qhh, Aa^Esa, Ha, Ha, Aa, Gs, Ha, Ha, Aa^Fma, Ha^Fda, Aa, Aa, Aa^Fpa, Aa^Fpa, Aa^Fpa, Aa^Qhuf, Aa^Fpa, Aa^Fpa, Cfa, Cfa, Aa, Ww^Qhu, Aa, Ha^Esa, Ha
Aa, Aa^Esa, Re^Gvs, Aa^Qhh, Aa^Qhh, Cva, Cva^_mh, Cva, Cva, Rra, Rra, Rp, Rp, Gd^Es, Gd^Es, Aa^Qhhf, Aa^Fpa, Aa^Fpa, Aa^Esa, Aa, Gs, Aa^Fma, Ha, Ha, Aa^Qhhf, Aa^Qhhf, Aa^Qhhf, Aa^Fpa, Aa^Fpa, Aa^Fpa, Gd^Efm, Aa^Qhu, Gd, Aa, Cfa, Ha^Qhu, Ai, Ha, Ms^Xm, Ha^Esa
Re^Gvs, Re^Gvs, Re^Gvs, Re^Gvs, Aa^Qhh, Cva, Gs^Ebn, 1 Kva, Cva, Re, Re, Aa^Feta, Rp, Gd^Em, Aa, Aa^Qhh, Aa, Ha, Aa^Fpa, Aa^Esa, Ha, Gs, Gll, Ha^Fda, Aa^Qhhf, Gs^Esa, Gll^Esa, Aa^Qhhf, Aa^Qhhf, Aa^Fma, Gs^Efm, Gs^Qhu, Aa^Qhu, Gd, Aa^Esa, Ha^Qhu, Ai, Ai, Ha, Ms^Xm
Gd, Re^Gvs, Gs^Qhh, Gd^Qhh, Aa^Esa, Aa, Cva, Cva, Gs, Re, Aa^Esa, Aa^Es, Rp, Aa^Vla, Ha, Aa^Qhh, Aa, Ha, Aa, Aa^Fpa, Aa^Fpa, Gll, Aa, Aa^Qhhf, Aa^Esa, Aa^Es, Gll^Em, Aa^Fpa, Aa^Qhhf, Gll, Gll^Efm, Gs, Gs^Efm, Aa^Qhu, Aa^Qhu, Aa^Qhu, Ww^Qhu, Ms, Ms^Xm, Ha
Gd, Gs, Aa^Qhh, Aa, Aa^Vla, Aa^Esa, Aa, Aa, Gd^Eff, Aa^Eff, Aa^Eff, Aa^Esa, Rp, Gd, Gd^Qhh, Aa^Qhh, Aa, Aa^Fpa, Aa, Aa^Fma, Aa^Fpa, Aa^Fpa, Aa^Fpa, Aa^Qhhf, Aa^Fma, Aa^Esa, Aa^Fma, Aa^Fpa, Ha^Qhhf, Aa^Fpa, Gll^Es, Aa^Fpa, Aa^Fpa, Gs, Aa^Fpa, Aa^Fpa, Ww^Qhu, Ha, Ms^Xm, Ms^Xm
Gd, Gs, Rp, Aa^Qhh, Gd^Qhh, Aa^Em, Aa^Eff, Gd^Eff, Re^Gvs, Re^Gvs, Re^Gvs, Gd^Eff, Gd, Rp, Gd^Qhh, Gd, Aa^Fpa, Aa^Fpa, Aa^Fpa, Aa^Fpa, Aa, Aa, Aa^Fma, Aa^Qhhf, Aa^Qhhf, Aa^Fda, Aa^Fda, Aa^Fda, Ha^Qhhf, Ha, Aa, Gs, Aa^Fma, Aa^Fpa, Aa^Fpa, Aa^Fpa, Re^Qhu, Ha, Ms, Ms^Xm
Rp, Rp, Gd, Rp, Gd^Qhh, Aa, Aa^Fma, Re^Gvs, Re^Gvs, Re^Gvs, Aa^Qhhf, Aa^Qhhf, Gd^Qhh, Rp^Qhh, Gd, Gd, Aa^Fpa, Ha, Aa, Aa^Fma, Aa, Ha, Aa, Aa^Fpa, Aa^Qhhf, Aa^_mh, Aa^Fma, Aa^Qhhf, Ha, Aa^Fma, Aa^Fma, Aa, Aa^Fda, Aa^Fma, Aa^Fpa, Re^Qhu, Ww^Qhu, Ww^Qhu, Ms, Ms^Xm
Gd, Gd, Aa^Fda, Rp, Gd^Qhh, Aa, Aa, Aa^Esa, Aa^Esa, Aa, Aa^Qhhf, Aa^Fpa, Aa, Rp, Gd, Aa^Fpa, Aa^Esa, Aa, Gd, Gd, Aa^Fma, Aa, Gs, Aa^Fpa, Gs, Aa^Qhhf, Aa^Qhhf, Aa^Qhhf, Aa, Aa, Aa^Fma, Aa^Fma, Aa^Fda, Aa^Fda, Gs^Qhu, Re^Qhu, Ww^Qhu, Ha, Ms^Xm, Ms^Xm
Aa^Fda, Aa^Fda, Aa^Fda, Rp, Rp, Rp^Qhh, Rp^Qhh, Aa, Aa^Qhh, Aa^Qhhf, Aa, Aa^Fpa, Aa^Esa, Rp, Rp, Aa^Fpa, Aa, Aa^Esa, Gd, Gd, Ds, Gs, Aa, Aa^Fma, Aa^Fma, Gs, Gs, Aa^Esa, Aa^Esa, Aa^Fma, Re, Aa^Fpa, Aa^Fpa, Aa^Fma, Aa^Qhuf, Re^Qhu, Ha, Ha, Ms^Xm, Ms^Xm
Aa^Fda, Aa^Fda, Gd, Gd, Aa^Vla, Aa^Esa, Aa^Esa, Rp^Qhh, Rp, Aa, Ww, Aa, Ai, Aa^Esa, Ww, Rp, Ww, Ai, Ai, Ds, Wo, Ds, Aa^Esa, Aa^Fma, Aa, Aa, Gs, Aa^Fma, Re, Re, Re, Aa^Fpa, Gll^Em, Aa^Qhuf, Re^Qhu, Re^Qhu, Ms, Ms^Xm, Ms, Ms^Xm
Aa^Fda, Aa^Fda, Gd, Aa, Aa, Aa, Ww, Aa, Ai, Ww^Bw\, Wo^Bw\, Ww, Wo, Wo, Ww, Ww^Bsb|, Ww, Wo, Wo, Wo, Ww, Ds, Ai, Aa^Esa, Re, Re, Re, Re, Re, Aa^Fma, Aa^Fma, Re, Re, Re^Qhu, Aa^Vha, Ms, Ww, Ms, Ww, Ww
Aa, Aa, Aa, Gd, Ww, Ww, Ww^Ewf, Ww, Ww, Wo, Ww, Wo^Bw|, Ai, Ai^Esa, Ai^Esa, Rp, Ds, Ai, Ai, Ww, Ai, Ww, Ww^Bw|, Ai^Bw/, Ww, Aa^Vca, Gs, Gs, Aa^Fpa, Aa^Fma, Aa^Fda, Re^Eff, Re^Eff, Aa^Fma, Gll, Ms, Ai, Ww, Ww, Ww
Aa, Aa, Ai, Ww, Re, Ww, Ww, Ww, Aa, Ww, Aa, Rp, Aa^Esa, Ai, Rp, Rp, Gs, Ds, Aa, Aa^Esa, Aa^Esa, Ai, Gd, Ww, Ww, Wwf, Aa^Esa, Gs, Aa, Aa^Fda, Aa^Fda, Aa^Fpa, Aa^Fpa, Aa^Fma, Gll, Ai, Wo, Wo, Ww, Ww
Ai, Ai, Ai, Aa^Vla, Aa^Fda, Re, Re^Gvs, Re^Gvs, Re^Gvs, Aa^Esa, Aa^Esa, Rp, Aa, Aa^Esa, Rp, Gd, Aa, Aa, Aa^Fpa, Aa, Aa, Gd, Aa, Aa, Gd, Ww, Aa, Aa^Esa, Gd, Aa^Fda, Aa^Fma, Aa, Aa^Fpa, Aa^Fpa, Aa^Esa, Ai, Ww, Wo, Ww, Ww
Ms, Ms, Ww, Aa^Fda, Aa^Fda, Re^Gvs, Re^Gvs, Re^Gvs, Re^Gvs, Re^Gvs, Gs, Rp, Rp, Gs, Rp, Gs, Aa, Aa^Fpa, Gs^Efm, Aa^Fpa, Aa^Fpa, Gll, Ha, Ha^Dr, Aa^Esa, Ww, Ww^Bw/, Aa, Aa, Gd, Aa^Esa, Gd, Gd, Aa^Fma, Aa^Vha, Aa^Esa, Chw, Ai, Ms^Xm, Ms^Xm
Ms, Ms^Xm, Ms, Ww, Ai, Aa^Fda, Gs, Re^Gvs, Aa, Gs, Aa, Gs, Rp^Qhu, Rp, Aa, Aa, Gd^Efm, Gs^Efm, Gs^Efm, Aa^Fpa, Aa^Fpa, Gll, Ha^Esa, Ha^Dr, Aa^Qhh, Aa^Esa, Re^Edb, Ww, Ww, Ww, Ai, Aa^Esa, Aa, Aa^Fma, Aa^Fma, Aa, Ww, Ai, Ai^Esa, Ms^Xm
Ms, Ms, Ha, Ha, Ai, Gs, Gs, Aa, Aa^Qhuf, Aa^Fda, Aa^Qhu, Rp^Qhu, Gs, Gs^Qhu, Aa^Esa, Gs^Efm, Gs^Efm, Aa^Esa, Aa^Esa, Aa, Aa, Gd, Re^Qhh, Re^Qhh, Re, Re^Qhh, Re^Qhh, Gd^Qhh, Aa^Qhh, Re^Edb, Re^Qhh, Ai, Ai, Ww, Ww, Ww, Ds^Es, Ds, Ai, Ai^Esa
Ms, Ms, Ms, Ai, Aa^Fda, Aa, Gs^Qhu, Aa^Qhu, Re, Aa^Qhuf, Re, Rp, Rp, Aa^Qhu, Aa^Qhu, Aa^Esa, Rp^Qhu, Aa^Qhu, Rp^Qhu, Gs, Gs^Esa, Gs, Gd^Qhh, Gd^Es, Re, Re, Gd^Es, Gd^Es, Gd, Aa^Qhh, Cea^Esa, Cha^Qhh, Gd^Qhh, Ww, Aa^Fma, Wo, Wo, Ds^Es, Ww, Ai
Ms^Xm, Ms, Ha, Ai, Re, Re, Re^Qhu, Re, Aa, Re, Aa^Esa, Aa^Esa, Gs, Rp, Rp, Rp^Qhu, Gs^Esa, Rp, Gs^Qhu, Rp, Rp, Gs^Qhh, Gd^Es, Re, Re, Cva^Vea, Re, Re^Edb, Re, Cea^_mh, 2 Kva, Cea, Aa^Esa, Aa^Qhh, Aa^Fma, Gd, Wo, Ds, Ww, Ww
Ms^Xm, Ms^Xm, Ms, Wwf, Ww, Aa^Esa, Aa^Qhuf, Gs, Re, Aa^Vla, Re^Gvs, Re^Gvs, Re^Gvs, Gs^Eff, Gs^Eff, Gs, Gs^Wm, Gs^Esa, Aa^Qhu, Aa, Rp, Re^Qhh, Re, Re, Gs, Re, Gs^Edb, Re^Edb, Gs, Cea^Esa, Cea^Esa, Aa^Fma, Aa^Qhhf, Aa^Qhhf, Aa^Fpa, Aa, Ai^Esa, Ds, Ai, Ww
Ms^Xm, Ms^Xm, Ms, Ha, Ww, Aa, Aa^Qhuf, Gs^_ml, Re^Gvs, Re^Gvs, Re^Gvs, Re^Gvs, Gs^Eff, Gs^Eff, Aa, Aa^Esa, Aa^Qhu, Gd^Qhu, Aa, Aa^Esa, Aa, Rp^Qhh, Ha^Dr, Ha^Dr, Gd, Gd, Gd, Gd, Gd, Cea^Esa, Aa^Esa, Aa^Fma, Aa^Qhhf, Aa^Fpa, Aa^Fpa, Aa^Fpa, Aa^Fpa, Ai^Esa, Aa^Fpa, Ai
Ms^Xm, Ms^Xm, Ms, Ms, Ww, Aa^Fda, Aa^Qhuf, Aa^Fma, Aa^Fma, Re^Gvs, Aa^Fma, Gs^Eff, Aa^Qhuf, Gs^Qhu, Aa^Qhuf, Aa^Qhuf, Aa^Fma, Gd, Aa^Fma, Aa, Gs, Rp^Qhh, Rp^Qhh, Ha^Esa, Aa^Qhh, Aa^Qhhf, Aa^Qhhf, Aa, Aa^Qhhf, Aa, Aa^Qhhf, Aa^Qhhf, Aa^Vha, Aa^Fpa, Aa^Fpa, Aa^Fpa, Aa^Fpa, Aa^Fpa, Aa^Fpa, Aa^Fpa
Ms^Xm, Ms^Xm, Ms^Xm, Ms, Ai, Aa^Fda, Aa^Fda, Aa^Qhuf, Aa^Qhuf, Aa^Qhuf, Aa^Qhuf, Aa^Qhuf, Aa^Fda, Gs, Gs, Aa^Fma, Aa^Fma, Aa^Fma, Aa^Fma, Aa, Gs, Gs, Rp, Aa^Qhh, Gs, Aa^Fma, Aa^Fma, Aa^Qhhf, Aa^Fma, Aa^Qhhf, Aa^Fma, Aa^Fma, Aa^Fma, Aa^Fma, Aa^Fma, Aa^Fma, Aa^Fma, Aa^Fpa, Aa^Fma, Aa^Fma
Ms^Xm, Ms^Xm, Ms^Xm, Ms^Xm, Ai, Aa^Fda, Aa^Fda, Aa^Fma, Aa^Fda, Aa^Fma, Aa^Fda, Aa^Fda, Aa^Fda, Gs, Gs, Aa^Fma, Aa^Fma, Aa^Fma, Aa^Fma, Aa, Gs, Gs, Rp, Gs, Gs, Aa^Fma, Aa^Fma, Aa^Fma, Aa^Fma, Aa^Fma, Aa^Fma, Aa^Fma, Aa^Fma, Aa^Fma, Aa^Fma, Aa^Fma, Aa^Fma, Aa^Fpa, Aa^Fma, Aa^Fma
