Xof, Xof, Xof, Xof, Xof, Xof, Xof, Xof, Xof, Xof, Xof, Xof, Xof, Xof, Xof, Xof, Xof, Xof, Xof, Xof, Xof, Xof, Xof, Xof, Xof, Xof, Xof, Xof, Xof, Xof, Xof
Xof, Xof, Xof, Xof, Xof, Xof, Xof, Xof, Xof, Xof, Xof, Xof, Xof, Xof, Xof, Xof, Xof, Xof, Xof, Xof, Xof, Xof, Xof, Xof, Xof, Xof, Xof, Xof, Xof, Xof, Xof
Xof, Xof, Xof, Xof, Xof, Xof, Xof, Xof, Xof, Xof, Xof, Xof, Xof, Xof, Xof, Xof, Xof, Xof, Xof, Xof, Xof, Xof, Xof, Xof, Xof, Xof, Xof, Xof, Xof, Xof, Xof
Isr, Xof, Xof, Xof, Xof, Xof, Xof, Xof, Xof, Xof, Xof, Xof, Xof, Xof, Xof, Xof, Xof, Xof, Xof, Xof, Xof, Xof, Xof, Xof, Xof, Xof, Xof, Xof, Xof, Xof, Isr
Isr, Isr, Isr^Ebn, Xof, Xof, Xof, Xof, Xof, Xof, Xof, Xof, Xof, Xof, Xof, Xof, Xof, Xof, Xof, Xof, Xof, Xof, Xof, Xof, Xof, Xof, Xof, Xof, Xof, Isr^Ebn, Isr, Wwg
Isr, Isr, 1 Isr^Ii, Isr, Isr, Xof, Xof, Xof, Xof, Xof, Xof, Xof, Xof, Xof, Gs^Fms, Gs^Fms, Gs^Fms, Xof, Xof, Xof, Xof, Xof, Xof, Xof, Xof, Xof, Isr, Isr, Wwg^Ii, Wwg^Ii, Wwg^Ewf
Isr, Isr^Ii, Isc, Isc, Isc, Isr^Ebn, Isr, Xof, Xof, Xof, Xof, Xof, Gs^Fds, Gs^Fds, Gs^Efm, Gs^Fms, Gs^Efm, Gs^Fds, Gs^Fds, Xof, Xof, Xof, Xof, Xof, Isr, Isr^Ebn, Wwg, Wwg, Wwg^Ewf, Wwg^Ii, Wwg
Xof, Isr, Isr^Ebn, Isc, Isc, Isc^Ii, Isr^Ii, Isr, Isr^Ebn, Xof, Xof, Gs^Fp, Gs^Fms, Gs^Efm, Gs^Fp, Gs^Fp, Gs^Fp, Gs^Efm, Gs^Fms, Gs^Fp, Xof, Xof, Isr^Ebn, Isr, Wwg, Wwg, Wwg^Ii, Wwg^Ewl, Wwg, Wwg, Isr
Xof, Xof, Xof, Isr, Isr, Isr^Ii, Isc, Isc, Isc, Isr, Isr, Xof, Xof, Gs^Fms, Isr, Isr, Isr, Gs^Fms, Xof, Xof, Isr, Isr, Wwg^Ii, Wwg, Wwg^Ewl, Wwg^Ewf, Wwg^Ii, Wwg^Ii, Isr, Isr^Ebn, Xof
Xof, Xof, Xof, Xof, Xof, Isr^Ebn, Isr, Isc, Isc^Ii, Isc^Ii, Isr, Isr^Ebn, Isr, Isr^Ii, Isr^Ii, Kha^Efs, Isr, Isr, Isr, Cha, Cha, Isr^Ii, Isr^Ii, Wwg, Wwg, Wwg, Isr^Ebn, Isr, Xof, Xof, Xof
Xof, Xof, Xof, Xof, Gs^Fp, Xof, Xof, Isr, Isr^Ebn, Isr^Ii, Isc, Isc, Isc^Ii, Isr, Isr, Isr, Wwg^Qhu, Isr, Isc, Isr, Isr, Kha, Cha, Isr, Isr, Isr, Xof, Xof, Xof, Xof, Xof
Xof, Xof, Gs^Fms, Gs^Fms, Gs^Efm, Gs^Fds, Gs^Fds, Xof, Isr, Isr, Isr, Isc^Ii, Isc^Ii, Isc, Wwg^Qhu, Wwg^Qhu, Wwg^Ewl, Wwg^Qhu, Wwg^Qhu, Isc, Isc, Isr, Isr, Cha, Xof, Xof, Gs^Fms, Gs^Fp, Gs^Fp, Xof, Xof
Xof, Xof, Gs^Fds, Gs^Efm, Gs^Fet, Gs^Fp, Isr^Ii, Isr^Ii, Kha^Efs, Isr, Isr, Isr, Wwg^Qhu, Wwg^Qhu, Wwg^Ewl, Wwg^Ewl, Isr^Ebn, Wwg^Ewf, Wwg^Ewl, Wwg^Qhu, Wwg^Qhu, Isr, Isr, Isr, Isr^Ii, Gs^Fp, Gs^Fms, Gs^Efm, Gs^Efm, Gs^Fp, Xof
Xof, Xof, Gs^Fds, Gs^Efm, Gs^Efm, Gs^Fms, Gs^Fp, Isr, Isr, Isr, Isr, Wwg^Qhu, Wwg^Qhu, Wwg^Ewl, Wwg^Ewf, Isr^_ml, Wwg^Ewf, Wwg^Ewl, Wwg^Qhu, Wwg^Qhu, Isr, Isr, Isr, Kha^Efs, Isr, Isr^Ii, Gs^Fp, Gs^Fet, Gs^Efm, Gs^Fds, Xof
Xof, Xof, Xof, Gs^Fp, Gs^Fp, Gs^Fms, Xof, Xof, Cha, Isr, Isr, Isc, Isc, Wwg^Qhu, Wwg^Qhu, Wwg^Ewl, Wwg^Qhu, Wwg^Qhu, Isc, Isc, 2 Isc^Ii, Isr^Ii, Isr, Isr, Xof, Gs^Fds, Gs^Fds, Gs^Efm, Gs^Fms, Gs^Fds, Xof
Xof, Xof, Xof, Xof, Xof, Xof, Isr, Isr, Isr, Cha, Kha, Isr, Isr, Isc, Isr, Wwg^Qhu, Isr, Isr, Isr, Isc, Isc, Isc^Ii, Isr, Isr^Ebn, Isr, Xof, Xof, Gs^Fp, Xof, Xof, Xof
Xof, Xof, Xof, Xof, Isr, Isr^Ebn, Wwg, Wwg, Wwg^Ii, Isr^Ii, Isr, Cha, Cha, Isr^Ii, Isr^Ii, Isr, Kha^Efs, Isr, Isr, Isr, Isr^Ebn, Isr, Isc^Ii, Isc, Isc, Isr, Isr^Ebn, Xof, Xof, Xof, Xof
Xof, Xof, Isr^Ebn, Isr, Wwg^Ii, Wwg^Ii, Wwg^Ewf, Wwg^Ewl, Wwg, Wwg^Ii, Isr, Isr, Xof, Xof, Gs^Fms, Isr, Isr, Isr, Gs^Fms, Xof, Xof, Isr, Isr^Ii, Isc^Ii, Isc, Isc, Isr^Ii, Isr^Ii, Isr, Xof, Xof
Isr, Isr, Wwg, Wwg, Wwg^Ewf, Wwg^Ii, Wwg, Wwg, Isr, Isr^Ebn, Xof, Xof, Gs^Fp, Gs^Fms, Gs^Efm, Gs^Fp, Gs^Fp, Gs^Fp, Gs^Efm, Gs^Fms, Gs^Fp, Xof, Xof, Isr^Ebn, Isr, Isr, Isc, Isc^Ii, Isc, Isr^Ebn, Isr
Wwg, Wwg, Wwg^Ii, Wwg^Ewl, Wwg, Wwg, Isr^Ebn, Isr, Xof, Xof, Xof, Xof, Xof, Gs^Fp, Gs^Fp, Gs^Efm, Gs^Fms, Gs^Efm, Gs^Fp, Gs^Fp, Xof, Xof, Xof, Xof, Xof, Isr, Isr^Ebn, Isc, Isr^Ii, Isr, Isr
Wwg^Ewl, Wwg^Ewf, Wwg^Ii, Wwg^Ii, Isr, Isr, Xof, Xof, Xof, Xof, Xof, Xof, Xof, Xof, Xof, Gs^Fms, Gs^Fms, Gs^Fms, Xof, Xof, Xof, Xof, Xof, Xof, Xof, Xof, Xof, Isr, Isr^Ii, Isr^Ii, Isr
Wwg, Wwg, Isr, Isr^Ebn, Xof, Xof, Xof, Xof, Xof, Xof, Xof, Xof, Xof, Xof, Xof, Xof, Xof, Xof, Xof, Xof, Xof, Xof, Xof, Xof, Xof, Xof, Xof, Xof, Xof, Isr^Ebn, Isr
Isr, Isr, Xof, Xof, Xof, Xof, Xof, Xof, Xof, Xof, Xof, Xof, Xof, Xof, Xof, Xof, Xof, Xof, Xof, Xof, Xof, Xof, Xof, Xof, Xof, Xof, Xof, Xof, Xof, Xof, Xof
Xof, Xof, Xof, Xof, Xof, Xof, Xof, Xof, Xof, Xof, Xof, Xof, Xof, Xof, Xof, Xof, Xof, Xof, Xof, Xof, Xof, Xof, Xof, Xof, Xof, Xof, Xof, Xof, Xof, Xof, Xof
Xof, Xof, Xof, Xof, Xof, Xof, Xof, Xof, Xof, Xof, Xof, Xof, Xof, Xof, Xof, Xof, Xof, Xof, Xof, Xof, Xof, Xof, Xof, Xof, Xof, Xof, Xof, Xof, Xof, Xof, Xof
Xof, Xof, Xof, Xof, Xof, Xof, Xof, Xof, Xof, Xof, Xof, Xof, Xof, Xof, Xof, Xof, Xof, Xof, Xof, Xof, Xof, Xof, Xof, Xof, Xof, Xof, Xof, Xof, Xof, Xof, Xof
Xof, Xof, Xof, Xof, Xof, Xof, Xof, Xof, Xof, Xof, Xof, Xof, Xof, Xof, Xof, Xof, Xof, Xof, Xof, Xof, Xof, Xof, Xof, Xof, Xof, Xof, Xof, Xof, Xof, Xof, Xof
